"Zork I - The Great Underground Empire" by "Infocom (translated to Inform 7)"

The story headline is "An Interactive Fiction".
The story genre is "Fantasy".
The release number is 3.
The story creation year is 1980.
The story description is "ZORK is a game of adventure, danger, and low cunning. In it you will explore some of the most amazing territory ever seen by mortals. No computer should be without one!"

Use American dialect.
Use scoring.
The maximum score is 350.

Part 1 - Configuration and Extensions

Chapter 1 - Bibliographic and Settings

The player is in West-of-House.

When play begins:
	now the left hand status line is "[the player's surroundings] [if in darkness]   [otherwise]   Score: [score]/[turn count][end if]";
	now the right hand status line is "".

After printing the banner text:
	say "v3: Multimedia[line break]";
	say "Translated to Inform 7 by John Escobedo[line break]";
	say "Original by Marc Blank, Dave Lebling, Bruce Daniels, and Tim Anderson[line break]";
	say "Copyright (c) 1981-1986 Infocom, Inc. ZIL source released under MIT License.[paragraph break]".

Chapter 2 - Verbosity Modes

Verbosity mode is a kind of value. The verbosity modes are superbrief-mode, brief-mode, and verbose-mode.
The current verbosity is a verbosity mode that varies. The current verbosity is brief-mode.

Superbriefing is an action out of world.
Understand "superbrief" as superbriefing.
Carry out superbriefing:
	now the current verbosity is superbrief-mode;
	say "Superbrief descriptions."

Verbosing is an action out of world.
Understand "verbose" as verbosing.
Carry out verbosing:
	now the current verbosity is verbose-mode;
	say "Maximum verbosity.";
	try looking.

Briefing is an action out of world.
Understand "brief" as briefing.
Carry out briefing:
	now the current verbosity is brief-mode;
	say "Brief descriptions."

Chapter 3 - Score Ranks

Table of Rankings
score	rank
0	"Beginner"
25	"Amateur Adventurer"
50	"Novice Adventurer"
100	"Junior Adventurer"
200	"Adventurer"
300	"Master"
330	"Wizard"
350	"Master Adventurer"

After printing the player's obituary:
	say "[line break]";
	follow the score and rank rule.

This is the score and rank rule:
	say "Your score is [score] (total of 350 points), in [turn count] move[if turn count is not 1]s[end if].[line break]This gives you the rank of ";
	let current-rank be "Beginner";
	repeat through the Table of Rankings:
		if the score is at least the score entry:
			now current-rank is the rank entry;
	say "[current-rank].[line break]".

Carry out requesting the score:
	if the player-is-dead is true:
		say "You're dead! How can you think of your score?";
		stop the action;
	follow the score and rank rule;
	stop the action.

Chapter 4 - Death and Resurrection

The player-deaths is a number that varies. The player-deaths is 0.
The player-is-dead is a truth state that varies. The player-is-dead is false.
The always-lit-mode is a truth state that varies. The always-lit-mode is false.

To die saying (reason - text):
	say "[reason][line break]";
	if the player-is-dead is true:
		say "[line break]It takes a talented person to be killed while already dead. YOU are such a talent. Unfortunately, it takes a talented person to deal with it. I am not such a talent. Sorry.[line break]";
		end the story;
		stop;
	if the lucky-flag is false:
		say "Bad luck, huh?[line break]";
	decrease the score by 10;
	say "[line break]    ****  You have died  ****[line break][line break]";
	if the player-deaths is at least 2:
		say "You clearly are a suicidal maniac. We don't allow psychotics in the cave, since they may harm other adventurers. Your remains will be installed in the Land of the Living Dead, where your fellow adventurers may gloat over them.[line break]";
		end the story;
		stop;
	increase the player-deaths by 1;
	if the match-lit is true:
		now the match-lit is false;
		now the match-timer is 0;
	if South Temple is visited:
		say "As you take your last breath, you feel relieved of your burdens. The feeling passes as you find yourself before the gates of Hell, where the spirits jeer at you and deny you entry. Your senses are disturbed. The objects in the dungeon appear indistinct, bleached of color, even unreal.[paragraph break]";
		now the player-is-dead is true;
		now the troll-flag is true;
		now the always-lit-mode is true;
		now the player carries the spirit-glow;
		scatter-possessions;
		move the player to Entrance to Hades;
	otherwise:
		say "Now, let's take a look here...[line break]Well, you probably deserve another chance. I can't quite fix you up completely, but you can't have everything.[paragraph break]";
		scatter-possessions;
		move the player to Forest1.

The spirit-glow is a thing. It is lit. It is undescribed.
Rule for deciding whether all includes the spirit-glow: it does not.

To scatter-possessions:
	now every thing carried by the player is in West-of-House;
	if the player encloses the brass lantern:
		now the brass lantern is in Living Room.

Section - Ghost State Actions

Instead of attacking something when the player-is-dead is true:
	say "All such attacks are vain in your condition."

Instead of taking something when the player-is-dead is true:
	say "Your hand passes through its object."

Instead of removing something from something when the player-is-dead is true:
	say "Your hand passes through its object."

Instead of dropping something when the player-is-dead is true:
	say "You have no possessions."

Instead of throwing something at something when the player-is-dead is true:
	say "You have no possessions."

Instead of taking inventory when the player-is-dead is true:
	say "You have no possessions."

Instead of waiting when the player-is-dead is true:
	say "Might as well. You've got an eternity."

Instead of switching on the brass lantern when the player-is-dead is true:
	say "You need no light to guide you."

Instead of opening something when the player-is-dead is true:
	say "Even such an action is beyond your capabilities."

Instead of closing something when the player-is-dead is true:
	say "Even such an action is beyond your capabilities."

Instead of eating something when the player-is-dead is true:
	say "Even such an action is beyond your capabilities."

Instead of drinking something when the player-is-dead is true:
	say "Even such an action is beyond your capabilities."

Instead of turning something when the player-is-dead is true:
	say "Even such an action is beyond your capabilities."

Instead of burning something when the player-is-dead is true:
	say "Even such an action is beyond your capabilities."

Instead of tying something to something when the player-is-dead is true:
	say "Even such an action is beyond your capabilities."

Instead of rubbing something when the player-is-dead is true:
	say "Even such an action is beyond your capabilities."

Instead of switching on something when the player-is-dead is true:
	say "Even such an action is beyond your capabilities."

Instead of switching off something when the player-is-dead is true:
	say "Even such an action is beyond your capabilities."

Instead of locking something with something when the player-is-dead is true:
	say "Even such an action is beyond your capabilities."

Instead of unlocking something with something when the player-is-dead is true:
	say "Even such an action is beyond your capabilities."

Instead of pushing something when the player-is-dead is true:
	say "Even such an action is beyond your capabilities."

Instead of pulling something when the player-is-dead is true:
	say "Even such an action is beyond your capabilities."

Instead of touching something when the player-is-dead is true:
	say "Even such an action is beyond your capabilities."

Instead of squeezing something when the player-is-dead is true:
	say "Even such an action is beyond your capabilities."

Instead of searching something when the player-is-dead is true:
	say "Even such an action is beyond your capabilities."

Instead of waving something when the player-is-dead is true:
	say "Even such an action is beyond your capabilities."

Instead of putting something on something when the player-is-dead is true:
	say "Even such an action is beyond your capabilities."

Instead of inserting something into something when the player-is-dead is true:
	say "Even such an action is beyond your capabilities."

Instead of giving something to someone when the player-is-dead is true:
	say "Even such an action is beyond your capabilities."

Instead of doing anything when the player-is-dead is true (this is the ghost state catch-all rule):
	if we are looking or we are examining or we are going or we are praying or we are looking under:
		continue the action;
	say "You can't even do that."

Section - Ghost State Looking

Before looking when the player-is-dead is true:
	if the location is a dark room:
		say "Although there is no light, the room seems dimly illuminated.[line break]";
	say "The room looks strange and unearthly[if the number of visible things in the location is 0].[otherwise] and objects appear indistinct.[end if]";
	say "[line break]".

Chapter 5 - Darkness and Grues

[ZIL grue behavior: attacks only on movement, never on non-movement actions.
Two triggers: (1) V-WALK — trying to go a direction with no exit while in dark,
(2) GOTO — successfully moving from one dark room to another dark room.
Moving from a lit room into a dark room is always safe (warning only).]

The was-in-dark is a truth state that varies. The was-in-dark is false.

Rule for printing the description of a dark room:
	if the always-lit-mode is false:
		say "It is pitch black. You are likely to be eaten by a grue.[line break]" instead;
	otherwise:
		say "It is pitch black.[line break]" instead.

To grue-death:
	play the sound of grue-sfx as sfx;
	let R be a random number between 1 and 3;
	if R is 1:
		die saying "Oh, no! A lurking grue slithered into the room and devoured you!";
	otherwise if R is 2:
		die saying "Oh, no! You have walked into the slavering fangs of a lurking grue!";
	otherwise:
		die saying "Oh, no! You have walked into a den of hungry grues and it[apostrophe]s dinner time!".

[Record lighting state before any movement attempt]
Before going (this is the save darkness state rule):
	if in darkness:
		now the was-in-dark is true;
	otherwise:
		now the was-in-dark is false;
	continue the action.

[ZIL GOTO check: moving dark-to-dark has 80% grue death]
After going when the was-in-dark is true and in darkness (this is the dark-to-dark grue rule):
	if the always-lit-mode is false and a random chance of 4 in 5 succeeds:
		grue-death;
	continue the action.

[ZIL V-WALK check: trying to move in a direction with no exit while in dark]
Instead of going nowhere when in darkness (this is the dark-movement grue rule):
	if the always-lit-mode is false and a random chance of 4 in 5 succeeds:
		grue-death;
	say "You can[apostrophe]t go that way."

After deciding the scope of the player when in darkness:
	repeat with item running through things enclosed by the location:
		place item in scope.

Chapter 6 - Lamp Timer System

The lamp-turns is a number that varies. The lamp-turns is 0.
The lamp-stage is a number that varies. The lamp-stage is 0.
The lamp-burned-out is a truth state that varies. The lamp-burned-out is false.

Every turn when the brass lantern is lit:
	increase the lamp-turns by 1;
	if the lamp-stage is 0 and the lamp-turns is at least 200:
		now the lamp-stage is 1;
		if the player can see the brass lantern:
			say "The lamp appears a bit dimmer.[line break]";
	if the lamp-stage is 1 and the lamp-turns is at least 300:
		now the lamp-stage is 2;
		if the player can see the brass lantern:
			say "The lamp is definitely dimmer now.[line break]";
	if the lamp-stage is 2 and the lamp-turns is at least 370:
		now the lamp-stage is 3;
		if the player can see the brass lantern:
			say "The lamp is nearly out.[line break]";
	if the lamp-turns is at least 385:
		now the lamp-burned-out is true;
		now the brass lantern is not lit;
		now the lamp-stage is 4;
		if the player can see the brass lantern:
			say "You'd better have more light than from the brass lantern.[line break]".

Chapter 6a - Candle Timer System

The candle-turns is a number that varies. The candle-turns is 0.
The candle-stage is a number that varies. The candle-stage is 0.
The candles-burned-out is a truth state that varies. The candles-burned-out is false.
The candle-timer-active is a truth state that varies. The candle-timer-active is false.

After taking the pair of candles:
	now the candle-timer-active is true;
	continue the action.

Every turn when the pair of candles is lit and the candle-timer-active is true (this is the candle timer rule):
	increase the candle-turns by 1;
	if the candle-stage is 0 and the candle-turns is at least 40:
		now the candle-stage is 1;
		if the player can see the pair of candles:
			say "The candles grow shorter.[line break]";
	if the candle-stage is 1 and the candle-turns is at least 60:
		now the candle-stage is 2;
		if the player can see the pair of candles:
			say "The candles are becoming quite short.[line break]";
	if the candle-stage is 2 and the candle-turns is at least 70:
		now the candle-stage is 3;
		if the player can see the pair of candles:
			say "The candles won't last long now.[line break]";
	if the candle-turns is at least 75:
		now the candles-burned-out is true;
		now the pair of candles is not lit;
		now the candle-stage is 4;
		if the player can see the pair of candles:
			say "You'd better have more light than from the pair of candles.[line break]".

Chapter 6b - Match Lighting System

The match-lit is a truth state that varies. The match-lit is false.
The match-timer is a number that varies. The match-timer is 0.

Lighting-match is an action applying to nothing. Understand "light match" and "light a match" and "strike match" as lighting-match.

Instead of switching on the matchbook:
	try lighting-match.

Carry out lighting-match:
	if the player does not carry the matchbook:
		say "You don't have the matchbook." instead;
	if the match-count is 0:
		say "I'm afraid that you have run out of matches." instead;
	decrease the match-count by 1;
	if the player is in Drafty Room or the player is in Timber Room:
		say "This room is drafty, and the match goes out instantly." instead;
	now the match-lit is true;
	now the match-timer is 2;
	play the sound of match-sfx as sfx;
	say "One of the matches starts to burn."

Every turn when the match-lit is true (this is the match burn timer rule):
	decrease the match-timer by 1;
	if the match-timer is at most 0:
		now the match-lit is false;
		say "The match has gone out.[line break]".

Extinguishing-match is an action applying to nothing. Understand "blow out match" and "extinguish match" as extinguishing-match.

Carry out extinguishing-match:
	if the match-lit is true:
		now the match-lit is false;
		now the match-timer is 0;
		say "The match is out.";
		if in darkness:
			say "[line break]It's pitch black in here!";
	otherwise:
		say "No match is lit."

Chapter 7 - Trophy Case Scoring

The trophy-case-score is a number that varies. The trophy-case-score is 0.

Every turn (this is the trophy case scoring rule):
	let new-score be 0;
	repeat with item running through things in the trophy case:
		increase new-score by the treasure-value of the item;
		repeat with inner running through things enclosed by the item:
			increase new-score by the treasure-value of the inner;
	if new-score is not the trophy-case-score:
		let diff be new-score minus the trophy-case-score;
		increase the score by diff;
		now the trophy-case-score is new-score;
	if the score is at least 350 and the won-flag is false:
		now the won-flag is true;
		now the ancient map is zil-visible;
		say "[line break]An almost inaudible voice whispers in your ear, [quotation mark]Look to your treasures for the final secret.[quotation mark][line break]".

Chapter 8 - Treasure Values

A thing has a number called treasure-value.
A person can be defeated. A person is usually not defeated. The treasure-value of a thing is usually 0.
A thing has a number called point-value. The point-value of a thing is usually 0.

After taking something when the point-value of the noun is greater than 0 (this is the first-take scoring rule):
	increase the score by the point-value of the noun;
	now the point-value of the noun is 0;
	continue the action.

Chapter 9 - Lucky Flag

The lucky-flag is a truth state that varies. The lucky-flag is true.

Chapter 10 - Sound and Audio System

Section 0 - Sound Toggle

The sound-enabled is a truth state that varies. The sound-enabled is false.

To decide whether glk sound is supported:
	(- (glk_gestalt(gestalt_Sound, 0)) -).

When play begins (this is the auto-enable sound rule):
	if glk sound is supported:
		now the sound-enabled is true;
		say "Sound enabled. Type SOUND OFF to mute.[paragraph break]";
		follow the ambient audio zone rule.

Enabling sound is an action out of world.
Understand "sound on" as enabling sound.
Carry out enabling sound:
	now the sound-enabled is true;
	now the current-zone is zone-silence;
	say "Sound enabled.";
	follow the ambient audio zone rule.

Disabling sound is an action out of world.
Understand "sound off" as disabling sound.
Carry out disabling sound:
	now the sound-enabled is false;
	stop ambient sound;
	say "Sound disabled."

Section 1 - Sound Declarations

[Ambient zone sounds]
Sound of forest-ambient is the file "forest.ogg".
Sound of house-ambient is the file "house.ogg".
Sound of cave-ambient is the file "cave.ogg".
Sound of water-ambient is the file "water.ogg".
Sound of rapids-ambient is the file "rapids.ogg".
Sound of loud-ambient is the file "loud.ogg".
Sound of hades-ambient is the file "hades.ogg".
Sound of mine-ambient is the file "mine.ogg".
Sound of machinery-ambient is the file "machinery.ogg".

[Sound effects]
Sound of bird-sfx is the file "bird.ogg".
Sound of creak-sfx is the file "creak.ogg".
Sound of window-sfx is the file "window.ogg".
Sound of trapdoor-sfx is the file "trapdoor.ogg".
Sound of bell-sfx is the file "bell.ogg".
Sound of spirits-sfx is the file "spirits.ogg".
Sound of bat-sfx is the file "bat.ogg".
Sound of footsteps-sfx is the file "footsteps.ogg".
Sound of machine-sfx is the file "machine.ogg".
Sound of inflate-sfx is the file "inflate.ogg".
Sound of coffin-sfx is the file "coffin.ogg".
Sound of match-sfx is the file "match.ogg".
Sound of grue-sfx is the file "grue.ogg".
Sound of flood-sfx is the file "flood.ogg".
Sound of sword-sfx is the file "sword.ogg".
Sound of laugh-sfx is the file "laugh.ogg".

Section 2 - Audio Zones

Audio-zone is a kind of value. The audio-zones are zone-silence, zone-forest, zone-house, zone-cave, zone-water, zone-rapids, zone-loud, zone-hades, zone-mine, and zone-machinery.

A room has an audio-zone. The audio-zone of a room is usually zone-cave.

The current-zone is an audio-zone that varies. The current-zone is zone-silence.

Section 3 - Zone Room Assignments

[Forest zone - outdoor above-ground areas]
The audio-zone of West-of-House is zone-forest.
The audio-zone of North-of-House is zone-forest.
The audio-zone of South-of-House is zone-forest.
The audio-zone of Behind House is zone-forest.
The audio-zone of Forest1 is zone-forest.
The audio-zone of Forest2 is zone-forest.
The audio-zone of Forest3 is zone-forest.
The audio-zone of Mountains is zone-forest.
The audio-zone of Forest Path is zone-forest.
The audio-zone of Up a Tree is zone-forest.
The audio-zone of Clearing is zone-forest.
The audio-zone of Grating Clearing is zone-forest.
The audio-zone of Canyon View is zone-forest.
The audio-zone of Rocky Ledge is zone-forest.
The audio-zone of On-the-Rainbow is zone-forest.
The audio-zone of End of Rainbow is zone-forest.
The audio-zone of Stone Barrow is zone-forest.

[House zone - house interior]
The audio-zone of Kitchen is zone-house.
The audio-zone of Living Room is zone-house.
The audio-zone of Attic is zone-house.

[Water zone - calm river and reservoir areas]
The audio-zone of River1 is zone-water.
The audio-zone of River2 is zone-water.
The audio-zone of River3 is zone-water.
The audio-zone of White Cliffs North is zone-water.
The audio-zone of White Cliffs South is zone-water.
The audio-zone of Shore is zone-water.
The audio-zone of Sandy Beach is zone-water.
The audio-zone of Sandy Cave is zone-water.
The audio-zone of In-Stream is zone-water.
The audio-zone of Stream View is zone-water.
The audio-zone of Dam-Base is zone-water.
The audio-zone of Dam-Lobby is zone-water.
The audio-zone of Reservoir-South is zone-water.
The audio-zone of Reservoir-North is zone-water.
The audio-zone of Reservoir is zone-water.

[Rapids zone - fast water areas]
The audio-zone of Aragain Falls is zone-rapids.
The audio-zone of Canyon Bottom is zone-rapids.
The audio-zone of River4 is zone-rapids.
The audio-zone of River5 is zone-rapids.

[Loud Room zone]
The audio-zone of Loud Room is zone-loud.

[Hades zone]
The audio-zone of Entrance to Hades is zone-hades.
The audio-zone of Land of the Dead is zone-hades.

[Mine zone - coal mine areas]
The audio-zone of Mine Entrance is zone-mine.
The audio-zone of Squeaky Room is zone-mine.
The audio-zone of Bat-Room is zone-mine.
The audio-zone of Shaft Room is zone-mine.
The audio-zone of Smelly Room is zone-mine.
The audio-zone of Gas Room is zone-mine.
The audio-zone of Mine1 is zone-mine.
The audio-zone of Mine2 is zone-mine.
The audio-zone of Mine3 is zone-mine.
The audio-zone of Mine4 is zone-mine.
The audio-zone of Ladder Top is zone-mine.
The audio-zone of Ladder Bottom is zone-mine.
The audio-zone of Dead End 5 is zone-mine.
The audio-zone of Timber Room is zone-mine.
The audio-zone of Drafty Room is zone-mine.
The audio-zone of Slide Room is zone-mine.

[Machinery zone - dam machinery areas]
The audio-zone of Dam-Room is zone-machinery.
The audio-zone of Maintenance Room is zone-machinery.
The audio-zone of Machine-Room is zone-machinery.

Section 4 - Background Channel Sound Phrases (in place of Sounds by Dannii Willis in Standard Rules - unindexed)

[Inform 7 creates two Glk sound channels at startup: gg_foregroundchan and
gg_backgroundchan. The standard "play the sound of X" phrase always uses the
foreground channel, so playing SFX interrupts ambient. These I6 inclusions
let us play ambient on the background channel independently.]

To play (SFX - sound name) as ambient looping:
	(- PlayOnBackgroundChannel({SFX}, -1); -).

To play (SFX - sound name) as sfx:
	(- if ((+ sound-enabled +)) VM_SoundEffect(ResourceIDsOfSounds-->{SFX}); -).

To stop ambient sound:
	(- StopBackgroundChannel(); -).

Include (-
Constant AMBIENT_VOL = 16384;       ! ~25% of max volume (65536)
Constant CROSSFADE_MS = 2000;        ! 2 second crossfade between zones
Constant FADEIN_SILENCE_MS = 5000;   ! 5 second fade-in from silence

Global bg_chan_b = 0;                 ! Second background channel for crossfading
Global bg_active = 0;                ! 0 = gg_backgroundchan, 1 = bg_chan_b
Global ambient_playing = 0;          ! Whether ambient sound is currently active

[ PlayOnBackgroundChannel resource_ID repeats res active_chan inactive_chan;
	res = ResourceIDsOfSounds-->resource_ID;
	if (res == 0) rtrue;
	if (~~glk_gestalt(gestalt_Sound, 0)) rtrue;

	! Ensure both background channels exist
	if (gg_backgroundchan == 0)
		gg_backgroundchan = glk_schannel_create(GG_BACKGROUNDCHAN_ROCK);
	if (bg_chan_b == 0)
		bg_chan_b = glk_schannel_create(412);

	if (ambient_playing) {
		! Crossfade: fade out current, fade in new on alternate channel
		if (bg_active == 0) {
			active_chan = gg_backgroundchan;
			inactive_chan = bg_chan_b;
		} else {
			active_chan = bg_chan_b;
			inactive_chan = gg_backgroundchan;
		}
		! Fade out the currently playing channel over 2 seconds
		glk_schannel_set_volume_ext(active_chan, 0, CROSSFADE_MS, 0);
		! Start new sound on alternate channel at volume 0, then fade in
		glk_schannel_set_volume(inactive_chan, 0);
		glk_schannel_play_ext(inactive_chan, res, repeats, 0);
		glk_schannel_set_volume_ext(inactive_chan, AMBIENT_VOL, CROSSFADE_MS, 0);
		! Toggle active channel
		bg_active = 1 - bg_active;
	} else {
		! No ambient currently playing - fade in from zero over 5 seconds
		if (bg_active == 0)
			active_chan = gg_backgroundchan;
		else
			active_chan = bg_chan_b;
		glk_schannel_set_volume(active_chan, 0);
		glk_schannel_play_ext(active_chan, res, repeats, 0);
		glk_schannel_set_volume_ext(active_chan, AMBIENT_VOL, FADEIN_SILENCE_MS, 0);
	}
	ambient_playing = 1;
];

[ StopBackgroundChannel;
	if (~~glk_gestalt(gestalt_Sound, 0)) rtrue;
	! Fade out both channels (active + any still fading from previous crossfade)
	if (gg_backgroundchan)
		glk_schannel_set_volume_ext(gg_backgroundchan, 0, CROSSFADE_MS, 0);
	if (bg_chan_b)
		glk_schannel_set_volume_ext(bg_chan_b, 0, CROSSFADE_MS, 0);
	ambient_playing = 0;
];
-).

Section 5 - Ambient Audio Rule

Every turn when the sound-enabled is true (this is the ambient audio zone rule):
	let Z be the audio-zone of the location;
	if Z is not the current-zone:
		now the current-zone is Z;
		if Z is zone-silence:
			stop ambient sound;
		otherwise if Z is zone-forest:
			play the sound of forest-ambient as ambient looping;
		otherwise if Z is zone-house:
			play the sound of house-ambient as ambient looping;
		otherwise if Z is zone-cave:
			play the sound of cave-ambient as ambient looping;
		otherwise if Z is zone-water:
			play the sound of water-ambient as ambient looping;
		otherwise if Z is zone-rapids:
			play the sound of rapids-ambient as ambient looping;
		otherwise if Z is zone-loud:
			play the sound of loud-ambient as ambient looping;
		otherwise if Z is zone-hades:
			play the sound of hades-ambient as ambient looping;
		otherwise if Z is zone-mine:
			play the sound of mine-ambient as ambient looping;
		otherwise if Z is zone-machinery:
			play the sound of machinery-ambient as ambient looping.

Part 2 - The World

Chapter 1 - Forest and Outside of House

Section 1 - Regions

House Exterior is a region.
The Forest Area is a region.
The House Interior is a region.
The Underground is a region.

Section 2 - Rooms Outside the House

West-of-House is a room. "You are standing in an open field west of a white house, with a boarded front door.[if the won-flag is true] A secret path leads southwest into the forest.[end if]".
The printed name of West-of-House is "West of House".
West-of-House is in House Exterior.

The white house is a backdrop. The white house is in House Exterior and Forest Area. The description of the white house is "The house is a beautiful colonial house which is painted white. It is clear that the owners must have been extremely wealthy."
Understand "house" and "white" and "beautiful" and "colonial" as the white house.

Instead of burning the white house:
	say "You must be joking."

Instead of taking or pushing or pulling or touching the white house when the location of the player is not in House Exterior:
	say "You're not at the house."

Finding is an action applying to one visible thing. Understand "find [something]" and "where is [something]" as finding.
Carry out finding: say "I couldn't find that."

Instead of finding the white house when the location of the player is in House Interior:
	say "Why not find your brains?"

Instead of finding the white house when the location of the player is the Clearing:
	say "It seems to be to the west."

Instead of finding the white house when the location of the player is in House Exterior:
	say "It's right here! Are you blind or something?"

Instead of finding the white house when the location of the player is not in House Exterior and the location of the player is not in House Interior and the location of the player is not the Clearing:
	say "It was here just a minute ago...."

Instead of entering the white house when the location of the player is Behind House:
	if the kitchen-window is open:
		try going west;
	otherwise:
		say "The window is closed."

Instead of entering the white house when the location of the player is in House Exterior and the location of the player is not Behind House:
	say "I can't see how to get in from here."

North-of-House is a room. "You are facing the north side of a white house. There is no door here, and all the windows are boarded up. To the north a narrow path winds through the trees."
The printed name of North-of-House is "North of House".
North-of-House is in House Exterior.

South-of-House is a room. "You are facing the south side of a white house. There is no door here, and all the windows are boarded."
The printed name of South-of-House is "South of House".
South-of-House is in House Exterior.

Behind House is a room. The printed name of Behind House is "Behind House".
Behind House is in House Exterior.

The description of Behind House is "You are behind the white house. A path leads into the forest to the east. In one corner of the house there is a small window which is [if the kitchen-window is open]open[otherwise]slightly ajar[end if]."

Section 3 - Map Connections Around the House

North-of-House is north of West-of-House. South-of-House is south of West-of-House.
Northeast of West-of-House is North-of-House. Southeast of West-of-House is South-of-House.
North of Behind House is North-of-House. South of Behind House is South-of-House.
Southwest of Behind House is South-of-House. Northwest of Behind House is North-of-House.
East of South-of-House is Behind House. West of South-of-House is West-of-House.
Northeast of South-of-House is Behind House. Northwest of South-of-House is West-of-House.
East of North-of-House is Behind House. West of North-of-House is West-of-House.
East of Behind House is Clearing.

Instead of going east in West-of-House:
	say "The door is boarded and you can't remove the boards."

The boarded-windows are a backdrop. The boarded-windows are in North-of-House and South-of-House.
The printed name of the boarded-windows is "boarded window".
Understand "window" and "windows" and "boarded" as the boarded-windows.
The description of the boarded-windows is "The windows are all boarded up."
Instead of opening the boarded-windows: say "The windows are boarded and can[apostrophe]t be opened."
Instead of attacking the boarded-windows: say "You can[apostrophe]t break the windows open."

Instead of going south in North-of-House:
	say "The windows are all boarded."

Instead of going north in South-of-House:
	say "The windows are all boarded."

Section 4 - Forest Rooms

Forest1 is a room. The printed name of Forest1 is "Forest". "This is a forest, with trees in all directions. To the east, there appears to be sunlight. A faint breeze stirs the branches overhead, carrying the earthy scent of decaying leaves and damp moss."
Forest1 is in Forest Area.
Forest1 is west of West-of-House.

Forest2 is a room. The printed name of Forest2 is "Forest". "This is a dimly lit forest, with large trees all around. The canopy here is thick, allowing only thin shafts of light to reach the forest floor. A carpet of pine needles muffles your footsteps."
Forest2 is in Forest Area.

Mountains is a room. The printed name of Mountains is "Forest". "The forest thins out, revealing impassable mountains."

Forest3 is a room. The printed name of Forest3 is "Forest". "This is a dimly lit forest, with large trees all around. Gnarled roots break through the soil underfoot, and the air is heavy with the smell of wet bark. Somewhere nearby, water drips steadily from the leaves."
Forest3 is in Forest Area.
Forest3 is south of South-of-House.
Northwest of Forest3 is South-of-House.
West of Forest3 is Forest1. South of Forest1 is Forest3.

Forest Path is a room. "This is a path winding through a dimly lit forest. The path heads north-south here. One particularly large tree with some low branches stands at the edge of the path."
Forest Path is in Forest Area.
North of North-of-House is Forest Path.
South of Forest Path is North-of-House. East of Forest Path is Forest2. West of Forest Path is Forest1. North of Forest1 is Grating Clearing.

East of Forest1 is Forest Path.

Forest2 is east of Mountains. Forest2 is north of Mountains. Forest2 is south of Mountains. Forest2 is west of Mountains.

North of Forest2 is nowhere. South of Forest2 is Clearing. West of Forest2 is Forest Path. East of Forest2 is Mountains.

North of Forest3 is Clearing. East of Forest3 is nowhere.

Instead of going north in Forest2:
	say "The forest becomes impenetrable to the north."

Instead of going east in Forest3:
	say "The rank undergrowth prevents eastward movement."

Instead of going south in Forest3:
	say "Storm-tossed trees block your way."

Instead of going up in Forest1:
	say "There is no tree here suitable for climbing."

Instead of going up in Forest2:
	say "There is no tree here suitable for climbing."

Instead of going up in Forest3:
	say "There is no tree here suitable for climbing."

The mountain-range is scenery in Mountains. The printed name of the mountain-range is "mountains".
Understand "mountain" and "mountains" and "range" and "impassable" and "flathead" as the mountain-range.
The description of the mountain-range is "The mountains are impassable."
Instead of climbing the mountain-range: say "Don[apostrophe]t you believe me? The mountains are impassable!"

Instead of going up in Mountains:
	say "The mountains are impassable."

Instead of going east in Mountains:
	say "The mountains are impassable."

Instead of going west in Forest1:
	say "You would need a machete to go further west."

Up a Tree is a room. "You are about 10 feet above the ground nestled among some large branches. The nearest branch above you is above your reach."
Up a Tree is in Forest Area.
Up a Tree is above Forest Path.

Instead of going up in Up a Tree:
	say "You cannot climb any higher."

After looking in Up a Tree:
	let item-list be a list of things;
	repeat with item running through things in Forest Path:
		if the item is not scenery and the item is not undescribed:
			add item to item-list;
	if the number of entries in item-list > 0:
		say "On the ground below you can see: [item-list with indefinite articles]."

Clearing is a room. "You are in a small clearing in a well marked forest path that extends to the east and west."
Clearing is in Forest Area.

North of Clearing is Forest2. South of Clearing is Forest3. West of Clearing is Behind House.
[East of Clearing is connected in Phase 7 - see Canyon View]

Instead of going up in Clearing:
	say "There is no tree here suitable for climbing."

Grating Clearing is a room. The printed name of Grating Clearing is "Clearing".
The description of Grating Clearing is "You are in a clearing, with a forest surrounding you on all sides. A path leads south.[if the grate is open][line break]There is an open grating, descending into darkness.[otherwise if the grate-revealed is true][line break]There is a grating securely fastened into the ground.[end if]".
Grating Clearing is in Forest Area.
North of Forest Path is Grating Clearing. East of Grating Clearing is Forest2. West of Grating Clearing is Forest1. South of Grating Clearing is Forest Path.

Instead of going north in Grating Clearing:
	say "The forest becomes impenetrable to the north."

Instead of going down in Grating Clearing:
	if the grate is not visible:
		say "You can't go that way." instead;
	if the grate is open:
		say "(through the grating)[line break]";
		move the player to Grating Room instead;
	otherwise:
		say "The grating is closed!" instead.

Section 5 - Songbird Ambient

The forest-songbird is a backdrop. The printed name of the forest-songbird is "songbird".
Understand "bird" and "songbird" and "song" as the forest-songbird.
The forest-songbird is in Forest Area.
The description of the forest-songbird is "The songbird is not here but is probably nearby."

Instead of taking the forest-songbird:
	say "The songbird is not here but is probably nearby."

Instead of listening to the forest-songbird:
	say "You can't hear the songbird now."

Every turn when the player is in the Forest Area (this is the songbird singing rule):
	if a random chance of 15 in 100 succeeds:
		play the sound of bird-sfx as sfx;
		say "You hear in the distance the chirping of a song bird.[line break]".

Section 5a - Forest Pseudo-Object

The forest-pseudo is a backdrop. The forest-pseudo is in Forest Area.
The printed name of the forest-pseudo is "forest".
Understand "forest" as the forest-pseudo when the player is in Forest Area.
The description of the forest-pseudo is "You cannot see the forest for the trees."

Instead of finding the forest-pseudo: say "You cannot see the forest for the trees."
Instead of listening to the forest-pseudo: say "The pines and the hemlocks seem to be murmuring."
Instead of exiting when the player is in Forest Area and the player is not in the magic boat: say "You will have to specify a direction."

Instead of following the forest-songbird: say "It can't be followed."

Section 6 - Forest Trees

The forest-trees is a backdrop. The printed name of the forest-trees is "trees".
Understand "tree" and "trees" and "branch" and "large" and "forest" and "pines" and "hemlocks" as the forest-trees.
The forest-trees is in Forest Area.
The description of the forest-trees is "The trees are tall and closely grown."

Instead of listening to the forest-trees:
	say "The pines and the hemlocks seem to be murmuring."

Instead of climbing the forest-trees when the player is in Forest Path:
	try going up.

Instead of climbing the forest-trees when the player is in Up a Tree:
	try going up.

Section 7 - Objects Outside the House

The small mailbox is a closed openable container in West-of-House. "There is a small mailbox here."
The description of the small mailbox is "It's a small mailbox."
Understand "mailbox" and "box" as the small mailbox.
The carrying capacity of the small mailbox is 2.

After opening the small mailbox:
	play the sound of creak-sfx as sfx;
	continue the action.

Instead of taking the small mailbox:
	say "It is securely anchored."

The leaflet is in the small mailbox. The description of the leaflet is "WELCOME TO ZORK![paragraph break]ZORK is a game of adventure, danger, and low cunning. In it you will explore some of the most amazing territory ever seen by mortals. No computer should be without one![paragraph break](v3: Sound — An Inform 7 translation)[line break]Translated to Inform 7 by John Escobedo[line break]Original by Marc Blank, Dave Lebling, Bruce Daniels, and Tim Anderson[line break]Copyright (c) 1981-1986 Infocom, Inc. ZIL source released under MIT License."
Understand "advertisement" and "leaflet" and "booklet" and "mail" and "small" as the leaflet.

The front door is scenery in West-of-House.
Understand "door" and "front" and "boarded" as the front door.
The description of the front door is "The door is boarded shut."

Instead of opening the front door:
	say "The door cannot be opened."

Instead of attacking the front door:
	say "You can't seem to damage the door."

Instead of burning the front door:
	say "You cannot burn this door."

Instead of looking under the front door:
	say "It won't open."

Instead of reading the front door:
	if the player is in Living Room:
		say "The engravings translate to [quotation mark]This space intentionally left blank.[quotation mark]";
	otherwise:
		say "There is no writing on this side."

The boards are scenery in West-of-House.
Understand "boards" and "board" as the boards.
The description of the boards is "The boards are securely fastened."

Instead of taking the boards:
	say "The boards are securely fastened."

The nails are scenery in West-of-House.
Understand "nails" and "nail" as the nails.
The description of the nails is "The nails are deeply imbedded in the door."
Instead of taking the nails: say "The nails, deeply imbedded in the door, cannot be removed."

Section 8 - Kitchen Window (a door)

The kitchen-window is a door. The kitchen-window is not open. The kitchen-window is scenery.
The printed name of the kitchen-window is "kitchen window".
Understand "window" and "kitchen" and "small" as the kitchen-window.
The kitchen-window is west of Behind House and east of Kitchen.

The description of the kitchen-window is "[if the kitchen-window-touched is false]The window is slightly ajar, but not enough to allow entry.[otherwise if the kitchen-window is open]The window is open.[otherwise]The window is closed.[end if]".

The kitchen-window-touched is a truth state that varies. The kitchen-window-touched is false.

Instead of opening the kitchen-window:
	if the kitchen-window is open:
		say "It is already open." instead;
	now the kitchen-window is open;
	now the kitchen-window-touched is true;
	play the sound of window-sfx as sfx;
	say "With great effort, you open the window far enough to allow entry."

Instead of closing the kitchen-window:
	if the kitchen-window is not open:
		say "It is already closed." instead;
	now the kitchen-window is not open;
	now the kitchen-window-touched is true;
	say "The window closes (more easily than it opened)."

Instead of searching the kitchen-window:
	if the player is in Kitchen:
		say "You can see a clear area leading towards a forest.";
	otherwise:
		say "You can see what appears to be a kitchen."

Chapter 2 - The House Interior

Section 1 - Kitchen

Kitchen is a room. Kitchen is in House Interior.
The description of Kitchen is "You are in the kitchen of the white house. A table seems to have been used recently for the preparation of food. A passage leads to the west and a dark staircase can be seen leading upward. A dark chimney leads down and to the east is a small window which is [if the kitchen-window is open]open[otherwise]slightly ajar[end if]."

West of Kitchen is Living Room. Above Kitchen is Attic.

Instead of going down in Kitchen:
	say "Only Santa Claus climbs down chimneys."

The chimney is a backdrop. The chimney is in Kitchen and Studio. Understand "chimney" and "dark" and "narrow" and "fireplace" as the chimney.
The description of the chimney is "[if the player is in Kitchen]The chimney leads downward, and looks climbable.[otherwise]The chimney leads upward, and looks climbable.[end if]"

The kitchen table is a supporter in Kitchen. The kitchen table is scenery.
Understand "table" and "kitchen" as the kitchen table.

The glass bottle is a closed transparent openable container on the kitchen table. "A bottle is sitting on the table."
Understand "bottle" and "container" and "clear" and "glass" as the glass bottle.
The carrying capacity of the glass bottle is 1.

Instead of inserting something into the glass bottle when the glass bottle contains something (called the existing contents):
	say "The bottle is full."

Instead of throwing the glass bottle at something:
	say "The bottle hits the far wall and shatters.";
	if the quantity of water is in the glass bottle:
		remove the quantity of water from play;
	remove the glass bottle from play.

Instead of attacking the glass bottle:
	say "A brilliant maneuver destroys the bottle.";
	if the quantity of water is in the glass bottle:
		remove the quantity of water from play;
	remove the glass bottle from play.

The quantity of water is a thing in the glass bottle.
Understand "water" and "quantity" and "liquid" and "h2o" as the quantity of water.
The description of the quantity of water is "It looks like plain water."

Instead of drinking the quantity of water:
	remove the quantity of water from play;
	say "Thank you very much. I was rather thirsty (from strenuously carrying everything for you)."

Instead of drinking something:
	say "How can you drink that?"

The global-water is a backdrop. The global-water is in Dam-Base, River1, River2, River3, River4, River5, White Cliffs North, White Cliffs South, Sandy Beach, Shore, Aragain Falls, End of Rainbow, Canyon Bottom, On-the-Rainbow, Reservoir-South, Reservoir-North, Stream View, In-Stream, and Reservoir.
The printed name of the global-water is "water".
Understand "water" and "river" and "lake" and "stream" as the global-water.
The description of the global-water is "It looks like water."

Instead of taking the global-water:
	if the player carries the glass bottle:
		if the glass bottle is not open:
			say "The bottle is closed.";
		otherwise if the glass bottle contains something:
			say "The water slips through your fingers.";
		otherwise:
			now the quantity of water is in the glass bottle;
			say "The bottle is now full of water.";
	otherwise:
		say "The water slips through your fingers."

Filling is an action applying to one thing. Understand "fill [something]" as filling.
Carry out filling: say "You can't fill that."

Instead of filling the glass bottle:
	if the player can see the global-water:
		if the glass bottle is not open:
			say "The bottle is closed.";
		otherwise if the glass bottle contains something:
			say "The bottle is full.";
		otherwise:
			now the quantity of water is in the glass bottle;
			say "The bottle is now full of water.";
	otherwise:
		say "There is nothing to fill it with."

Instead of taking the quantity of water when the quantity of water is in the glass bottle:
	say "It's in the bottle. Perhaps you should take that instead."

Instead of dropping the quantity of water:
	if the glass bottle is not open and the quantity of water is in the glass bottle:
		say "The bottle is closed.";
	otherwise if the player is in the magic boat:
		now the quantity of water is in the magic boat;
		say "There is now a puddle in the bottom of the magic boat.";
	otherwise:
		remove the quantity of water from play;
		say "The water spills to the floor and evaporates immediately."

Instead of inserting the quantity of water into something when the second noun is not the glass bottle:
	remove the quantity of water from play;
	say "Nice try."

Instead of throwing the quantity of water at something:
	remove the quantity of water from play;
	say "The water splashes on the walls and evaporates immediately."

Instead of entering the global-water:
	say "You can't swim in the dungeon."

Instead of swimming when the player can see the global-water:
	say "You can't swim in the dungeon."

The brown sack is a closed openable container on the kitchen table. "On the table is an elongated brown sack, smelling of hot peppers."
Understand "bag" and "sack" and "brown" and "elongated" and "smelly" as the brown sack.
The carrying capacity of the brown sack is 2.

Instead of smelling the brown sack:
	if the lunch is in the brown sack:
		say "It smells of hot peppers.";
	otherwise:
		say "It smells faintly of hot peppers."

The lunch is in the brown sack. The description of the lunch is "It looks like a hot pepper sandwich."
Understand "food" and "sandwich" and "lunch" and "dinner" and "hot" and "pepper" as the lunch.

Instead of eating the lunch:
	remove the lunch from play;
	say "Thank you very much. It really hit the spot."

The clove of garlic is in the brown sack. The description of the clove of garlic is "It's a clove of garlic."
Understand "garlic" and "clove" as the clove of garlic.

Instead of eating the clove of garlic:
	remove the clove of garlic from play;
	say "What the heck! You won't make friends this way, but nobody around here is too friendly anyhow. Gulp!"

Section 2 - Attic

Attic is a room. "This is the attic, a low-ceilinged room thick with dust and the faint smell of old wood. Exposed rafters run overhead, and pale light filters through cracks in the boarded-up windows. The only exit is a stairway leading down."
Attic is in House Interior. Attic is a dark room.

The attic table is a supporter in Attic. The attic table is scenery.
Understand "table" as the attic table.

The nasty knife is on the attic table. "On a table is a nasty-looking knife."
Understand "knives" and "knife" and "blade" and "nasty" as the nasty knife.

The rope is in Attic. "A large coil of rope is lying in the corner."
Understand "rope" and "hemp" and "coil" and "large" as the rope.
The description of the rope is "It's a large coil of sturdy hemp rope."

Section 3 - Living Room

Living Room is a room. Living Room is in House Interior.

The description of Living Room is "You are in the living room. There is a doorway to the east[if the magic-flag is true]. To the west is a cyclops-shaped opening in an old wooden door, above which is some strange gothic lettering, [otherwise], a wooden door with strange gothic lettering to the west, which appears to be nailed shut, [end if]a trophy case, [if the rug-moved is false]and a large oriental rug in the center of the room.[otherwise if the trap door is open]and a rug lying beside an open trap door.[otherwise]and a closed trap door at your feet.[end if]"

The trophy case is a transparent openable open container in Living Room. The trophy case is scenery. "The trophy case is mounted firmly to the wall."
Understand "case" and "trophy" as the trophy case.
The carrying capacity of the trophy case is 100.

Instead of taking the trophy case:
	say "The trophy case is securely fastened to the wall."

Instead of closing the trophy case: say "[dummy]".

After looking when the location is Living Room and the number of things in the trophy case is greater than 0:
	say "Your collection of treasures consists of:";
	repeat with item running through things in the trophy case:
		say "[line break]  [a item]";
	say "[paragraph break]".

The sword is in Living Room. "Above the trophy case hangs an elvish sword of great antiquity."
Understand "sword" and "orcrist" and "glamdring" and "blade" and "elvish" and "old" and "antique" as the sword.
The description of the sword is "It's an old elvish sword of great antiquity."
The treasure-value of the sword is 0.

The brass lantern is in Living Room. "A battery-powered brass lantern is on the trophy case."
Understand "lamp" and "lantern" and "light" and "brass" as the brass lantern.
The description of the brass lantern is "[if the lamp-burned-out is true]The lamp has burned out.[otherwise if the brass lantern is lit]The lamp is on.[otherwise]The lamp is turned off.[end if]".

Instead of switching on the brass lantern:
	if the lamp-burned-out is true:
		say "A burned-out lamp won't light." instead;
	now the brass lantern is lit;
	say "The brass lantern is now on."

Instead of switching off the brass lantern:
	if the lamp-burned-out is true:
		say "The lamp has already burned out." instead;
	now the brass lantern is not lit;
	say "The brass lantern is now off."

The broken lamp is a thing. The printed name of the broken lamp is "broken lantern".
Understand "lamp" and "lantern" and "broken" as the broken lamp.
The description of the broken lamp is "The lamp is seriously damaged."

Instead of switching on the broken lamp: say "The lamp is broken."
Instead of switching off the broken lamp: say "The lamp is broken."

Instead of throwing the brass lantern at something:
	say "The lamp has smashed into the floor, and the light has gone out.";
	now the brass lantern is not lit;
	now the lamp-burned-out is true;
	now the broken lamp is in the location;
	remove the brass lantern from play.

The old wooden door is scenery in Living Room. Understand "door" and "wooden" and "gothic" and "strange" and "lettering" and "writing" as the old wooden door.
The description of the old wooden door is "[if the magic-flag is true]The door has a cyclops-shaped opening in it.[otherwise]The engravings translate to 'This space intentionally left blank.'[end if]".

Instead of opening the old wooden door:
	if the magic-flag is true:
		say "The door is already open -- the cyclops saw to that.";
	otherwise:
		say "The door is nailed shut."

Instead of going west in Living Room:
	if the magic-flag is true:
		continue the action;
	say "The door is nailed shut."

Section 4 - Rug and Trap Door Puzzle

The rug-moved is a truth state that varies. The rug-moved is false.

The carpet is scenery in Living Room. Understand "rug" and "carpet" and "large" and "oriental" as the carpet.
The description of the carpet is "[if the rug-moved is false]A large oriental rug covers the center of the room.[otherwise]The carpet has been moved to one side of the room.[end if]".

Instead of taking the carpet:
	say "The rug is extremely heavy and cannot be carried."

Instead of pushing the carpet:
	try the-rug-move.
Instead of pulling the carpet:
	try the-rug-move.

The-rug-move is an action applying to nothing.

Carry out the-rug-move:
	if the rug-moved is true:
		say "Having moved the carpet previously, you find it impossible to move it again." instead;
	now the rug-moved is true;
	now the trap door is zil-visible;
	say "With a great effort, the rug is moved to one side of the room, revealing the dusty cover of a closed trap door."

Instead of entering the carpet:
	if the rug-moved is false and the trap door is not open:
		say "As you sit, you notice an irregularity underneath it. Rather than be uncomfortable, you stand up again.";
	otherwise:
		say "I suppose you think it[apostrophe]s a magic carpet?"

Instead of looking under the carpet:
	if the rug-moved is false and the trap door is not open:
		say "Underneath the rug is a closed trap door. As you drop the corner of the rug, the trap door is once again concealed from view.";
	otherwise:
		say "I suppose you think it's a magic carpet?"

Instead of raising the carpet:
	if the rug-moved is true:
		say "The rug is too heavy to lift.";
	otherwise:
		say "The rug is too heavy to lift, but in trying to take it you have noticed an irregularity beneath it."

The trap door is a door. The trap door is scenery. The trap door is closed and openable.
Understand "door" and "trapdoor" and "trap-door" and "cover" and "trap" and "dusty" as the trap door.
The trap door is below Living Room and above Cellar.

A thing can be zil-visible or zil-invisible. A thing is usually zil-visible. The trap door is zil-invisible.

Rule for writing a paragraph about a zil-invisible thing: now the item described is mentioned.
Before printing the locale description of a room (called the place):
	repeat with item running through zil-invisible things in the place:
		now item is mentioned.

Before doing anything to the trap door when the trap door is zil-invisible:
	say "You can't see any such thing." instead.

Before going down in Living Room:
	if the rug-moved is false:
		say "You can't go that way." instead;
	if the trap door is not open:
		say "The trap door is closed." instead.

Instead of opening the trap door when the player is in Living Room:
	if the trap door is zil-invisible:
		say "You can't see any such thing." instead;
	if the trap door is open:
		say "[dummy]" instead;
	now the trap door is open;
	say "The door reluctantly opens to reveal a rickety staircase descending into darkness."

Instead of closing the trap door when the player is in Living Room:
	if the trap door is not open:
		say "It is already closed." instead;
	now the trap door is not open;
	say "The door swings shut and closes."

Instead of looking under the trap door when the player is in Living Room:
	if the trap door is open:
		say "You see a rickety staircase descending into darkness.";
	otherwise:
		say "It[apostrophe]s closed."

The trap-door-touched is a truth state that varies. The trap-door-touched is false.

Section 5 - Objects in the Tree

The bird's nest is in Up a Tree. "Beside you on the branch is a small bird's nest."
Understand "nest" and "bird's" as the bird's nest.
The bird's nest is an open container. The carrying capacity of the bird's nest is 3.
The description of the bird's nest is "The bird's nest is a rough collection of twigs and grass."

The jewel-encrusted egg is in the bird's nest. "In the bird's nest is a large egg encrusted with precious jewels, apparently scavenged by a childless songbird. The egg is covered with fine gold inlay, and ornamented in lapis lazuli and mother-of-pearl. Unlike most eggs, this one is hinged and closed with a delicate looking clasp. The egg appears extremely fragile."

Rule for writing a paragraph about the bird's nest:
	say "Beside you on the branch is a small bird's nest.[line break]";
	if the jewel-encrusted egg is in the bird's nest and the jewel-encrusted egg is not handled:
		say "In the bird's nest is a large egg encrusted with precious jewels, apparently scavenged by a childless songbird. The egg is covered with fine gold inlay, and ornamented in lapis lazuli and mother-of-pearl. Unlike most eggs, this one is hinged and closed with a delicate looking clasp. The egg appears extremely fragile.[line break]";
		now the jewel-encrusted egg is mentioned.
Understand "egg" and "jewel" and "encrusted" and "jeweled" and "bird's" as the jewel-encrusted egg.
The jewel-encrusted egg is a closed openable container. The carrying capacity of the jewel-encrusted egg is 1.
The treasure-value of the jewel-encrusted egg is 5.
The point-value of the jewel-encrusted egg is 5.

Rule for writing a paragraph about the jewel-encrusted egg when the jewel-encrusted egg is open:
	if the golden clockwork canary is in the jewel-encrusted egg and the golden clockwork canary is not handled:
		say "There is a golden clockwork canary nestled in the egg. It has ruby eyes and a silver beak. Through a crystal window below its left wing you can see intricate machinery inside. It appears to have wound down.[line break]";
		now the golden clockwork canary is mentioned.

The golden clockwork canary is in the jewel-encrusted egg. "There is a golden clockwork canary nestled in the egg. It has ruby eyes and a silver beak. Through a crystal window below its left wing you can see intricate machinery inside. It appears to have wound down."
Understand "canary" and "clockwork" and "gold" and "golden" as the golden clockwork canary.
The treasure-value of the golden clockwork canary is 4.
The point-value of the golden clockwork canary is 6.
The description of the golden clockwork canary is "The canary is a beautiful golden clockwork device. It appears to have wound down."

The broken jewel-encrusted egg is a thing. The printed name of the broken jewel-encrusted egg is "broken jewel-encrusted egg". "There is a somewhat ruined egg here."
Understand "broken" and "egg" and "jewel" and "encrusted" as the broken jewel-encrusted egg.
The broken jewel-encrusted egg is an open container. The carrying capacity of the broken jewel-encrusted egg is 1.
The treasure-value of the broken jewel-encrusted egg is 2.

The broken clockwork canary is a thing. The printed name of the broken clockwork canary is "broken clockwork canary". "There is a golden clockwork canary nestled in the egg. It seems to have recently had a bad experience. The mountings for its jewel-like eyes are empty, and its silver beak is crumpled. Through a cracked crystal window below its left wing you can see the remains of intricate machinery. It is not clear what result winding it would have, as the mainspring seems sprung."
Understand "broken" and "canary" and "clockwork" and "gold" and "golden" as the broken clockwork canary.
The treasure-value of the broken clockwork canary is 1.

The beautiful brass bauble is a thing. "A beautiful brass bauble is here."
Understand "bauble" and "brass" and "beautiful" as the beautiful brass bauble.
The treasure-value of the beautiful brass bauble is 1.
The point-value of the beautiful brass bauble is 1.

Section 6 - Egg Fragility

The egg-broken is a truth state that varies. The egg-broken is false.

To break-the-egg:
	if the egg-broken is true, stop;
	now the egg-broken is true;
	if the golden clockwork canary is in the jewel-encrusted egg:
		say " There is a golden clockwork canary nestled in the egg. It seems to have recently had a bad experience. The mountings for its jewel-like eyes are empty, and its silver beak is crumpled. Through a cracked crystal window below its left wing you can see the remains of intricate machinery. It is not clear what result winding it would have, as the mainspring seems sprung.";
		now the broken clockwork canary is in the broken jewel-encrusted egg;
		remove the golden clockwork canary from play;
	otherwise:
		remove the broken clockwork canary from play;
	now the broken jewel-encrusted egg is in the holder of the jewel-encrusted egg;
	remove the jewel-encrusted egg from play.

Instead of opening the jewel-encrusted egg:
	if the jewel-encrusted egg is open:
		say "The egg is already open." instead;
	say "You have neither the tools nor the expertise."

Prying open it with is an action applying to two things. Understand "open [something] with [something]" as prying open it with.

Instead of prying open the jewel-encrusted egg with something:
	if the jewel-encrusted egg is open:
		say "The egg is already open." instead;
	if the second noun is a weapon:
		say "The egg is now open, but the clumsiness of your attempt has seriously compromised its esthetic appeal.";
		break-the-egg;
	otherwise:
		say "The concept of using a [second noun] is certainly original."

A thing can be a weapon or not a weapon. A thing is usually not a weapon.
The sword is a weapon. The nasty knife is a weapon.

Instead of entering the jewel-encrusted egg:
	say "There is a noticeable crunch from beneath you, and inspection reveals that the egg is lying open, badly damaged.";
	break-the-egg.

Instead of attacking the jewel-encrusted egg:
	say "Your rather indelicate handling of the egg has caused it some damage, although you have succeeded in opening it.";
	break-the-egg.

After dropping the jewel-encrusted egg in Up a Tree:
	say "The egg falls to the ground and springs open, seriously damaged.";
	now the jewel-encrusted egg is in Forest Path;
	break-the-egg.

After dropping the bird's nest in Up a Tree:
	if the jewel-encrusted egg is in the bird's nest:
		say "The nest falls to the ground, and the egg spills out of it, seriously damaged.";
		now the bird's nest is in Forest Path;
		now the jewel-encrusted egg is in Forest Path;
		break-the-egg;
	otherwise:
		say "The bird's nest falls to the ground.";
		now the bird's nest is in Forest Path.

Section 7 - Canary Wind-up and Bauble

The canary-sang is a truth state that varies. The canary-sang is false.

Winding is an action applying to one thing. Understand "wind [something]" and "wind up [something]" as winding.
Carry out winding: say "You cannot wind up a [noun]."

Instead of winding the golden clockwork canary:
	if the canary-sang is false and the player is in the Forest Area:
		now the canary-sang is true;
		say "The canary chirps, slightly off-key, an aria from a forgotten opera. From out of the greenery flies a lovely songbird. It perches on a limb just over your head and opens its beak to sing. As it does so a beautiful brass bauble drops from its mouth, bounces off the top of your head, and lands glimmering in the grass. As the canary winds down, the songbird flies away.";
		if the player is in Up a Tree:
			now the beautiful brass bauble is in Forest Path;
		otherwise:
			now the beautiful brass bauble is in the location of the player;
	otherwise:
		say "The canary chirps blithely, if somewhat tinnily, for a short time."

Instead of winding the broken clockwork canary:
	say "There is an unpleasant grinding noise from inside the canary."

Chapter 3 - Global Flags

The troll-flag is a truth state that varies. The troll-flag is false.
The magic-flag is a truth state that varies. The magic-flag is false.
The cyclops-flag is a truth state that varies. The cyclops-flag is false.
The dome-flag is a truth state that varies. The dome-flag is false.
The lld-flag is a truth state that varies. The lld-flag is false.
The low-tide is a truth state that varies. The low-tide is false.
The rainbow-flag is a truth state that varies. The rainbow-flag is false.
The won-flag is a truth state that varies. The won-flag is false.
The grate-revealed is a truth state that varies. The grate-revealed is false.
The gate-flag is a truth state that varies. The gate-flag is false.
The gates-open is a truth state that varies. The gates-open is false.

Part 3 - Underground Rooms

Chapter 1 - Cellar and Vicinity

Cellar is a dark room. "You are in a dark and damp cellar with a narrow passageway leading north, and a crawlway to the south. On the west is the bottom of a steep metal ramp which is unclimbable."
Cellar is in the Underground.

Instead of going west in Cellar:
	say "You try to ascend the ramp, but it is impossible, and you slide back down."

Instead of opening the trap door when the player is in Cellar:
	if the trap door is not open:
		say "The door is locked from above." instead.

Instead of closing the trap door when the player is in Cellar:
	if the trap door is open:
		say "The door closes and locks.";
		now the trap door is not open;
	otherwise:
		say "[dummy]"

After going down from Living Room to Cellar:
	if the trap-door-touched is false:
		now the trap-door-touched is true;
		now the trap door is not open;
		play the sound of trapdoor-sfx as sfx;
		say "The trap door crashes shut, and you hear someone barring it.[paragraph break]";
	continue the action.

North of Cellar is Troll-Room. South of Cellar is East-of-Chasm.

Chapter 2 - Troll-Room

Troll-Room is a dark room. The printed name of Troll-Room is "The Troll Room". "This is a small room with passages to the east and south and a forbidding hole leading west. Bloodstains and deep scratches (perhaps made by an axe) mar the walls."
Troll-Room is in the Underground.

Instead of going east in Troll-Room:
	if the troll-flag is false:
		say "The troll fends you off with a menacing gesture.";
	otherwise:
		move the player to East-West Passage.

Instead of going west in Troll-Room:
	if the troll-flag is false:
		say "The troll fends you off with a menacing gesture.";
	otherwise:
		move the player to Maze1.

Chapter 3 - Combat Melee Message System

Section 1 - Combat Variables

The melee-weapon is a thing that varies.
The melee-target is a person that varies.

Section 2 - Hero Attack Messages

Table of Hero Melee Messages
outcome (text)	message (text)
"miss"	"Your [melee-weapon] misses the [melee-target] by an inch."
"miss"	"A good slash, but it misses the [melee-target] by a mile."
"miss"	"You charge, but the [melee-target] jumps nimbly aside."
"miss"	"Clang! Crash! The [melee-target] parries."
"miss"	"A quick stroke, but the [melee-target] is on guard."
"miss"	"A good stroke, but it[apostrophe]s too slow; the [melee-target] dodges."
"unconscious"	"Your [melee-weapon] crashes down, knocking the [melee-target] into dreamland."
"unconscious"	"The [melee-target] is battered into unconsciousness."
"unconscious"	"A furious exchange, and the [melee-target] is knocked out!"
"unconscious"	"The haft of your [melee-weapon] knocks out the [melee-target]."
"unconscious"	"The [melee-target] is knocked out!"
"kill"	"It[apostrophe]s curtains for the [melee-target] as your [melee-weapon] removes his head."
"kill"	"The fatal blow strikes the [melee-target] square in the heart: He dies."
"kill"	"The [melee-target] takes a fatal blow and slumps to the floor dead."
"light-wound"	"The [melee-target] is struck on the arm; blood begins to trickle down."
"light-wound"	"Your [melee-weapon] pinks the [melee-target] on the wrist, but it[apostrophe]s not serious."
"light-wound"	"Your stroke lands, but it was only the flat of the blade."
"light-wound"	"The blow lands, making a shallow gash in the [melee-target][apostrophe]s arm!"
"serious-wound"	"The [melee-target] receives a deep gash in his side."
"serious-wound"	"A savage blow on the thigh! The [melee-target] is stunned but can still fight!"
"serious-wound"	"Slash! Your blow lands! That one hit an artery, it could be serious!"
"serious-wound"	"Slash! Your stroke connects! This could be serious!"
"stagger"	"The [melee-target] is staggered, and drops to his knees."
"stagger"	"The [melee-target] is momentarily disoriented and can[apostrophe]t fight back."
"stagger"	"The force of your blow knocks the [melee-target] back, stunned."
"stagger"	"The [melee-target] is confused and can[apostrophe]t fight back."
"stagger"	"The quickness of your thrust knocks the [melee-target] back, stunned."
"disarm"	"The [melee-target][apostrophe]s weapon is knocked to the floor, leaving him unarmed."
"disarm"	"The [melee-target] is disarmed by a subtle feint past his guard."

Section 3 - Troll Attack Messages

Table of Troll Melee Messages
outcome (text)	message (text)
"miss"	"The troll swings his axe, but it misses."
"miss"	"The troll[apostrophe]s axe barely misses your ear."
"miss"	"The axe sweeps past as you jump aside."
"miss"	"The axe crashes against the rock, throwing sparks!"
"unconscious"	"The flat of the troll[apostrophe]s axe hits you delicately on the head, knocking you out."
"kill"	"The troll neatly removes your head."
"kill"	"The troll[apostrophe]s axe stroke cleaves you from the nave to the chops."
"kill"	"The troll[apostrophe]s axe removes your head."
"light-wound"	"The axe gets you right in the side. Ouch!"
"light-wound"	"The flat of the troll[apostrophe]s axe skins across your forearm."
"light-wound"	"The troll[apostrophe]s swing almost knocks you over as you barely parry in time."
"light-wound"	"The troll swings his axe, and it nicks your arm as you dodge."
"serious-wound"	"The troll charges, and his axe slashes you on your [melee-weapon] arm."
"serious-wound"	"An axe stroke makes a deep wound in your leg."
"serious-wound"	"The troll[apostrophe]s axe swings down, gashing your shoulder."
"stagger"	"The troll hits you with a glancing blow, and you are momentarily stunned."
"stagger"	"The troll swings; the blade turns on your armor but crashes broadside into your head."
"stagger"	"You stagger back under a hail of axe strokes."
"stagger"	"The troll[apostrophe]s mighty blow drops you to your knees."
"disarm"	"The axe hits your [melee-weapon] and knocks it spinning."
"disarm"	"The troll swings, you parry, but the force of his blow knocks your [melee-weapon] away."
"disarm"	"The axe knocks your [melee-weapon] out of your hand. It falls to the floor."
"hesitate"	"The troll hesitates, fingering his axe."
"hesitate"	"The troll scratches his head ruminatively:  Might you be magically protected, he wonders?"
"sitting-duck"	"Conquering his fears, the troll puts you to death."

Section 4 - Thief Attack Messages

Table of Thief Melee Messages
outcome (text)	message (text)
"miss"	"The thief stabs nonchalantly with his stiletto and misses."
"miss"	"You dodge as the thief comes in low."
"miss"	"You parry a lightning thrust, and the thief salutes you with a grim nod."
"miss"	"The thief tries to sneak past your guard, but you twist away."
"unconscious"	"Shifting in the midst of a thrust, the thief knocks you unconscious with the haft of his stiletto."
"unconscious"	"The thief knocks you out."
"kill"	"Finishing you off, the thief inserts his blade into your heart."
"kill"	"The thief comes in from the side, feints, and inserts the blade into your ribs."
"kill"	"The thief bows formally, raises his stiletto, and with a wry grin, ends the battle and your life."
"light-wound"	"A quick thrust pinks your left arm, and blood starts to trickle down."
"light-wound"	"The thief draws blood, raking his stiletto across your arm."
"light-wound"	"The stiletto flashes faster than you can follow, and blood wells from your leg."
"light-wound"	"The thief slowly approaches, strikes like a snake, and leaves you wounded."
"serious-wound"	"The thief strikes like a snake! The resulting wound is serious."
"serious-wound"	"The thief stabs a deep cut in your upper arm."
"serious-wound"	"The stiletto touches your forehead, and the blood obscures your vision."
"serious-wound"	"The thief strikes at your wrist, and suddenly your grip is slippery with blood."
"stagger"	"The butt of his stiletto cracks you on the skull, and you stagger back."
"stagger"	"The thief rams the haft of his blade into your stomach, leaving you out of breath."
"stagger"	"The thief attacks, and you fall back desperately."
"disarm"	"A long, theatrical slash. You catch it on your [melee-weapon], but the thief twists his knife, and the [melee-weapon] goes flying."
"disarm"	"The thief neatly flips your [melee-weapon] out of your hands, and it drops to the floor."
"disarm"	"You parry a low thrust, and your [melee-weapon] slips out of your hand."
"hesitate"	"The thief, a man of superior breeding, pauses for a moment to consider the propriety of finishing you off."
"hesitate"	"The thief amuses himself by searching your pockets."
"hesitate"	"The thief entertains himself by rifling your pack."
"sitting-duck"	"The thief, forgetting his essentially genteel upbringing, cuts your throat."
"sitting-duck"	"The thief, a pragmatist, dispatches you as a threat to his livelihood."

Section 5 - Cyclops Attack Messages

Table of Cyclops Melee Messages
outcome (text)	message (text)
"miss"	"The Cyclops misses, but the backwash almost knocks you over."
"miss"	"The Cyclops rushes you, but runs into the wall."
"unconscious"	"The Cyclops sends you crashing to the floor, unconscious."
"kill"	"The Cyclops breaks your neck with a massive smash."
"light-wound"	"A quick punch, but it was only a glancing blow."
"light-wound"	"A glancing blow from the Cyclops[apostrophe] fist."
"serious-wound"	"The monster smashes his huge fist into your chest, breaking several ribs."
"serious-wound"	"The Cyclops almost knocks the wind out of you with a quick punch."
"stagger"	"The Cyclops lands a punch that knocks the wind out of you."
"stagger"	"Heedless of your weapons, the Cyclops tosses you against the rock wall of the room."
"disarm"	"The Cyclops grabs your [melee-weapon], tastes it, and throws it to the ground in disgust."
"disarm"	"The monster grabs you on the wrist, squeezes, and you drop your [melee-weapon] in pain."
"hesitate"	"The Cyclops seems unable to decide whether to broil or stew his dinner."
"sitting-duck"	"The Cyclops, no sportsman, dispatches his unconscious victim."

Section 6 - Melee Message Selection

To print hero melee for (O - text):
	let N be 0;
	repeat through the Table of Hero Melee Messages:
		if the outcome entry is O:
			increase N by 1;
	if N > 0:
		let R be a random number between 1 and N;
		let C be 0;
		let done be false;
		repeat through the Table of Hero Melee Messages:
			if done is false and the outcome entry is O:
				increase C by 1;
				if C is R:
					say "[message entry]";
					now done is true.

To print troll melee for (O - text):
	let N be 0;
	repeat through the Table of Troll Melee Messages:
		if the outcome entry is O:
			increase N by 1;
	if N > 0:
		let R be a random number between 1 and N;
		let C be 0;
		let done be false;
		repeat through the Table of Troll Melee Messages:
			if done is false and the outcome entry is O:
				increase C by 1;
				if C is R:
					say "[message entry]";
					now done is true.

To print thief melee for (O - text):
	let N be 0;
	repeat through the Table of Thief Melee Messages:
		if the outcome entry is O:
			increase N by 1;
	if N > 0:
		let R be a random number between 1 and N;
		let C be 0;
		let done be false;
		repeat through the Table of Thief Melee Messages:
			if done is false and the outcome entry is O:
				increase C by 1;
				if C is R:
					say "[message entry]";
					now done is true.

To print cyclops melee for (O - text):
	let N be 0;
	repeat through the Table of Cyclops Melee Messages:
		if the outcome entry is O:
			increase N by 1;
	if N > 0:
		let R be a random number between 1 and N;
		let C be 0;
		let done be false;
		repeat through the Table of Cyclops Melee Messages:
			if done is false and the outcome entry is O:
				increase C by 1;
				if C is R:
					say "[message entry]";
					now done is true.

Section 7 - Villain Death Message

To say sinister-black-fog for (V - a person):
	say "Almost as soon as the [V] breathes his last breath, a cloud of sinister black fog envelops him, and when the fog lifts, the carcass has disappeared."

Chapter 4 - Troll NPC

The troll is a person in Troll-Room. "[if the troll-unconscious is true]An unconscious troll is sprawled on the floor. All passages out of the room are open[otherwise if the troll carries the bloody axe]A nasty-looking troll, brandishing a bloody axe, blocks all passages out of the room[otherwise]A troll is here[end if]."
Understand "troll" and "nasty" as the troll.
The description of the troll is "[if the troll is defeated]The troll is dead.[otherwise if the troll-unconscious is true]An unconscious troll is sprawled on the floor. All passages out of the room are open.[otherwise if the troll carries the bloody axe]A nasty-looking troll, brandishing a bloody axe, blocks all passages out of the room.[otherwise]A troll is here.[end if]".
The troll-strength is a number that varies. The troll-strength is 2.
The troll-unconscious is a truth state that varies. The troll-unconscious is false.
The troll-recovery-chance is a number that varies. The troll-recovery-chance is 0.

The bloody axe is carried by the troll. "There is a bloody axe here."
Understand "axe" and "ax" and "bloody" as the bloody axe.
The bloody axe is a weapon.

Instead of taking the bloody axe when the troll is not defeated and the troll carries the bloody axe:
	say "The troll swings it out of your reach."

Instead of attacking the troll:
	if the troll is not in the location of the player:
		say "There is no troll here." instead;
	if the troll is defeated:
		say "The troll is already dead.";
	otherwise if the troll-unconscious is true:
		say "The unconscious troll cannot defend himself: He dies.";
		say "[line break][sinister-black-fog for the troll]";
		now the troll is defeated;
		now the troll-flag is true;
		now the troll-unconscious is false;
		now the troll-recovery-chance is 0;
		if the troll carries the bloody axe:
			now the bloody axe is in Troll-Room;
		remove the troll from play;
	otherwise:
		let W be a random weapon carried by the player;
		if W is nothing:
			say "Trying to attack the troll with your bare hands is suicidal.";
		otherwise:
			now the melee-weapon is W;
			now the melee-target is the troll;
			let hit-chance be a random number between 1 and 10;
			if hit-chance is at least 4:
				let outcome be a random number between 1 and 3;
				if outcome is 1:
					print hero melee for "unconscious";
					now the troll-unconscious is true;
					now the troll-recovery-chance is 0;
					now the troll-flag is true;
					if the troll carries the bloody axe:
						now the bloody axe is in Troll-Room;
				otherwise:
					decrease the troll-strength by 1;
					if the troll-strength is at most 0:
						print hero melee for "kill";
						say "[line break][sinister-black-fog for the troll]";
						now the troll is defeated;
						now the troll-flag is true;
						if the troll carries the bloody axe:
							now the bloody axe is in Troll-Room;
						remove the troll from play;
					otherwise:
						print hero melee for "light-wound";
			otherwise:
				print hero melee for "miss".

Instead of telling the troll about something:
	say "The troll isn't much of a conversationalist."

Instead of giving something to the troll:
	if the noun is the bloody axe:
		say "The troll scratches his head in confusion, then takes the axe.";
		now the troll carries the bloody axe;
	otherwise:
		say "The troll, who is not overly proud, graciously accepts the gift and eats it hungrily.";
		remove the noun from play.

Every turn when the troll is not defeated and the troll-unconscious is false and the troll is in Troll-Room and the player is in Troll-Room (this is the troll attacks rule):
	let W be a random weapon carried by the player;
	if W is not nothing:
		now the melee-weapon is W;
	if a random chance of 1 in 3 succeeds:
		if W is not nothing:
			print troll melee for "miss";
		otherwise:
			print troll melee for "kill";
			die saying "It appears that that last blow was too much for you. I'm afraid you are dead."

Every turn when the troll-unconscious is true and the troll is in Troll-Room (this is the troll recovery rule):
	if the troll-recovery-chance > 0:
		let roll be a random number between 1 and 100;
		if roll is at most the troll-recovery-chance:
			now the troll-unconscious is false;
			now the troll-recovery-chance is 0;
			now the troll-flag is false;
			if the bloody axe is in Troll-Room:
				now the troll carries the bloody axe;
			if the player is in Troll-Room:
				say "The troll stirs, quickly resuming a fighting stance.";
			rule succeeds;
	increase the troll-recovery-chance by 25.

Instead of taking the troll:
	say "The troll spits in your face, grunting [quotation mark]Better luck next time[quotation mark] in a rather barbarous accent."

Instead of pushing the troll:
	say "The troll laughs at your puny gesture."

Instead of listening to the troll:
	say "Every so often the troll says something, probably uncomplimentary, in his guttural tongue."

Instead of throwing something at the troll:
	if the troll is not in the location of the player:
		say "There is no troll here." instead;
	if the noun is a weapon:
		if a random chance of 1 in 5 succeeds:
			say "The troll, who is remarkably coordinated, catches the [noun] and, not having the most discriminating tastes, gleefully eats it. Poor troll, he dies from an internal hemorrhage and his carcass disappears in a sinister black fog.";
			remove the noun from play;
			now the troll is defeated;
			now the troll-flag is true;
			now the troll-unconscious is false;
			now the troll-recovery-chance is 0;
			if the troll carries the bloody axe:
				now the bloody axe is in Troll-Room;
			remove the troll from play;
		otherwise:
			say "The troll, who is remarkably coordinated, catches the [noun] and, being for the moment sated, throws it back. Fortunately, the troll has poor control, and the [noun] falls to the floor. He does not look pleased.";
			now the noun is in the location of the player;
	otherwise:
		say "The troll, who is remarkably coordinated, catches the [noun] and, not having the most discriminating tastes, gleefully eats it.";
		remove the noun from play.

Instead of answering the troll that "hello":
	if the troll is defeated:
		say "Unfortunately, the troll can[apostrophe]t hear you."

Chapter 5 - East-of-Chasm

East-of-Chasm is a dark room. "You are on the east edge of a chasm, the bottom of which cannot be seen. A narrow passage goes north, and the path you are on continues to the east."
The printed name of East-of-Chasm is "East of Chasm".
East-of-Chasm is in the Underground.

East of East-of-Chasm is Gallery.

Instead of going down in East-of-Chasm:
	say "The chasm probably leads straight to the infernal regions."

Gallery is a dark room. "This is an art gallery. Most of the paintings have been stolen by vandals with exceptional taste. The vandals left through either the north or west exits."
Gallery is in the Underground.

North of Gallery is Studio.

Studio is a dark room. "This appears to have been an artist's studio. The walls and floors are splattered with paints of 69 different colors. Strangely enough, nothing of value is hanging here. At the south end of the room is an open door (also covered with paint). A dark and narrow chimney leads up from a fireplace; although you might be able to get up it, it seems unlikely you could get back down."
Studio is in the Underground.

The ZORK owner's manual is in Studio. "Loosely attached to a wall is a small piece of paper."
Understand "manual" and "piece" and "paper" and "zork" and "owner's" and "small" as the ZORK owner's manual.
The description of the ZORK owner's manual is "Congratulations![paragraph break]You are the privileged owner of ZORK I: The Great Underground Empire, a self-contained and self-maintaining universe. If used and maintained in accordance with normal operating practices for small universes, ZORK will provide many months of trouble-free operation."

The studio-door is scenery in Studio. The printed name of the studio-door is "door".
Understand "door" as the studio-door.
The description of the studio-door is "The door is covered with paint."

Instead of opening or closing the studio-door:
	say "The door won't budge."

Instead of entering the studio-door:
	try going south.

The studio-paint is scenery in Studio. The printed name of the studio-paint is "paint".
Understand "paint" and "paints" and "splatter" as the studio-paint.
The description of the studio-paint is "The paints are of 69 different colors."

Instead of attacking the studio-paint:
	say "Some paint chips away, revealing more paint."

The painting-damaged is a truth state that varies. The painting-damaged is false.

The painting is in Gallery.
Understand "painting" and "art" and "canvas" and "beautiful" as the painting.
The initial appearance of the painting is "[if the painting-damaged is true]There is a worthless piece of canvas here.[otherwise]Fortunately, there is still one chance for you to be a vandal, for on the far wall is a painting of unparalleled beauty.[end if]".
The description of the painting is "[if the painting-damaged is true]Worthless piece of canvas.[otherwise]This is a masterwork of painting. It depicts a serene scene of a farmhouse on a hillside.[end if]".
The treasure-value of the painting is 6.
The point-value of the painting is 4.

Instead of attacking the painting:
	now the painting-damaged is true;
	now the treasure-value of the painting is 0;
	now the point-value of the painting is 0;
	say "Congratulations! Unlike the other vandals, who merely stole the artist's masterpieces, you have destroyed one."

Chapter 6 - Maze

Maze1 is a dark room. The printed name of Maze1 is "Maze". "This is part of a maze of twisty little passages, all alike."
Maze1 is in the Underground.
North of Maze1 is Maze1. South of Maze1 is Maze2. West of Maze1 is Maze4.

Maze2 is a dark room. The printed name of Maze2 is "Maze". "This is part of a maze of twisty little passages, all alike."
Maze2 is in the Underground.
South of Maze2 is Maze1. East of Maze2 is Maze3.

Instead of going down in Maze2:
	say "You won[apostrophe]t be able to get back up to the tunnel you are going through when it gets to the next room.";
	move the player to Maze4.

Maze3 is a dark room. The printed name of Maze3 is "Maze". "This is part of a maze of twisty little passages, all alike."
Maze3 is in the Underground.
West of Maze3 is Maze2. North of Maze3 is Maze4. Up from Maze3 is Maze5.

Maze4 is a dark room. The printed name of Maze4 is "Maze". "This is part of a maze of twisty little passages, all alike."
Maze4 is in the Underground.
West of Maze4 is Maze3. North of Maze4 is Maze1. East of Maze4 is Dead End 1.

Dead End 1 is a dark room. The printed name of Dead End 1 is "Dead End". "You have come to a dead end in the maze."
Dead End 1 is in the Underground.
South of Dead End 1 is Maze4.

Maze5 is a dark room. The printed name of Maze5 is "Maze". "This is part of a maze of twisty little passages, all alike.[line break]A skeleton, probably the remains of a luckless adventurer, lies here."
Maze5 is in the Underground.
East of Maze5 is Dead End 2. North of Maze5 is Maze3. Southwest of Maze5 is Maze6.

The skeleton is scenery in Maze5.  Understand "bones" and "skeleton" and "body" as the skeleton.
The description of the skeleton is "It's a skeleton, probably the remains of a luckless adventurer."

Instead of taking the skeleton:
	skeleton-curse.
Instead of pushing the skeleton:
	skeleton-curse.
Instead of attacking the skeleton:
	skeleton-curse.
Instead of rubbing the skeleton:
	skeleton-curse.
Instead of raising the skeleton:
	skeleton-curse.
Instead of lowering the skeleton:
	skeleton-curse.
Instead of touching the skeleton:
	skeleton-curse.
Instead of kicking the skeleton:
	skeleton-curse.
Instead of kissing the skeleton:
	skeleton-curse.

To skeleton-curse:
	say "A ghost appears in the room and is appalled at your desecration of the remains of a fellow adventurer. He casts a curse on your valuables and banishes them to the Land of the Living Dead. The ghost leaves, muttering obscenities.";
	repeat with item running through things carried by the player:
		if the treasure-value of item is greater than 0:
			now item is in Land of the Dead.

The burned-out lantern is in Maze5. "The deceased adventurer's useless lantern is here."
Understand "lantern" and "lamp" and "rusty" and "burned" and "dead" and "useless" as the burned-out lantern when the burned-out lantern is visible.

The leather bag of coins is in Maze5. "An old leather bag, bulging with coins, is here."
Understand "bag" and "coins" and "old" and "leather" as the leather bag of coins.
The treasure-value of the leather bag of coins is 5.
The point-value of the leather bag of coins is 10.

Instead of opening the leather bag of coins: say "The coins are safely inside; there[apostrophe]s no need to do that."
Instead of closing the leather bag of coins: say "The coins are safely inside; there[apostrophe]s no need to do that."
Instead of inserting something into the leather bag of coins: say "Don[apostrophe]t be silly. It wouldn[apostrophe]t be a leather bag of coins anymore."
Instead of searching the leather bag of coins: say "There are lots of coins in there."

The skeleton key is in Maze5. Understand "key" and "skeleton" as the skeleton key.
The description of the skeleton key is "It's a rusty old skeleton key."

The rusty knife is in Maze5. "Beside the skeleton is a rusty knife."
Understand "knife" and "rusty" as the rusty knife.
The rusty knife is a weapon.

Dead End 2 is a dark room. The printed name of Dead End 2 is "Dead End". "You have come to a dead end in the maze."
Dead End 2 is in the Underground.
West of Dead End 2 is Maze5.

Maze6 is a dark room. The printed name of Maze6 is "Maze". "This is part of a maze of twisty little passages, all alike."
Maze6 is in the Underground.
Down from Maze6 is Maze5. East of Maze6 is Maze7. West of Maze6 is Maze6. Up from Maze6 is Maze9.

Maze7 is a dark room. The printed name of Maze7 is "Maze". "This is part of a maze of twisty little passages, all alike."
Maze7 is in the Underground.
Up from Maze7 is Maze14. West of Maze7 is Maze6. East of Maze7 is Maze8. South of Maze7 is Maze15.

Instead of going down in Maze7:
	say "You won[apostrophe]t be able to get back up to the tunnel you are going through when it gets to the next room.";
	move the player to Dead End 1.

Maze8 is a dark room. The printed name of Maze8 is "Maze". "This is part of a maze of twisty little passages, all alike."
Maze8 is in the Underground.
Northeast of Maze8 is Maze7. West of Maze8 is Maze8. Southeast of Maze8 is Dead End 3.

Dead End 3 is a dark room. The printed name of Dead End 3 is "Dead End". "You have come to a dead end in the maze."
Dead End 3 is in the Underground.
North of Dead End 3 is Maze8.

Maze9 is a dark room. The printed name of Maze9 is "Maze". "This is part of a maze of twisty little passages, all alike."
Maze9 is in the Underground.
North of Maze9 is Maze6. East of Maze9 is Maze10. South of Maze9 is Maze13. West of Maze9 is Maze12. Northwest of Maze9 is Maze9.

Instead of going down in Maze9:
	say "You won[apostrophe]t be able to get back up to the tunnel you are going through when it gets to the next room.";
	move the player to Maze11.

Maze10 is a dark room. The printed name of Maze10 is "Maze". "This is part of a maze of twisty little passages, all alike."
Maze10 is in the Underground.
East of Maze10 is Maze9. West of Maze10 is Maze13. Up from Maze10 is Maze11.

Maze11 is a dark room. The printed name of Maze11 is "Maze". "This is part of a maze of twisty little passages, all alike."
Maze11 is in the Underground.
Northeast of Maze11 is Grating Room. Down from Maze11 is Maze10. Northwest of Maze11 is Maze13. Southwest of Maze11 is Maze12.

Grating Room is a dark room.
The description of Grating Room is "You are in a small room near the maze. There are twisty passages in the immediate vicinity.[if the grate is open][line break]Above you is an open grating with sunlight pouring in.[otherwise if the grate is not locked][line break]Above you is a grating.[otherwise][line break]Above you is a grating locked with a skull-and-crossbones lock.[end if]".
Grating Room is in the Underground.
Southwest of Grating Room is Maze11.

The grate is a door. The grate is scenery. The grate is closed and openable and lockable and locked. The matching key of the grate is the skeleton key.
Understand "grate" and "grating" as the grate.
The grate is above Grating Room and below Grating Clearing.

Instead of locking the grate with something when the grate is open:
	say "You can[apostrophe]t lock an open grate."

Instead of locking the grate with something when the player is in Grating Clearing:
	say "You can[apostrophe]t lock it from this side."

Instead of unlocking the grate with something when the player is in Grating Clearing:
	say "You can[apostrophe]t reach the lock from here."

Instead of unlocking the grate with something when the second noun is not the skeleton key:
	say "Can you unlock a grating with a [second noun]?"

Instead of inserting something into the grate when the grate is open and the player is in Grating Clearing:
	if the noun is the coffin or the noun is the trunk of jewels:
		say "It won[apostrophe]t fit through the grating.";
	otherwise:
		now the noun is in Grating Room;
		say "The [noun] goes through the grating into the darkness below."

Instead of going up in Grating Room:
	if the grate is not open:
		say "The grating is closed." instead;
	move the player to Grating Clearing.

Maze12 is a dark room. The printed name of Maze12 is "Maze". "This is part of a maze of twisty little passages, all alike."
Maze12 is in the Underground.
Southwest of Maze12 is Maze11. East of Maze12 is Maze13. Up from Maze12 is Maze9. North of Maze12 is Dead End 4.

Instead of going down in Maze12:
	say "You won[apostrophe]t be able to get back up to the tunnel you are going through when it gets to the next room.";
	move the player to Maze5.

Dead End 4 is a dark room. The printed name of Dead End 4 is "Dead End". "You have come to a dead end in the maze."
Dead End 4 is in the Underground.
South of Dead End 4 is Maze12.

Maze13 is a dark room. The printed name of Maze13 is "Maze". "This is part of a maze of twisty little passages, all alike."
Maze13 is in the Underground.
East of Maze13 is Maze9. Down from Maze13 is Maze12. South of Maze13 is Maze10. West of Maze13 is Maze11.

Maze14 is a dark room. The printed name of Maze14 is "Maze". "This is part of a maze of twisty little passages, all alike."
Maze14 is in the Underground.
West of Maze14 is Maze15. Northwest of Maze14 is Maze14. Northeast of Maze14 is Maze7. South of Maze14 is Maze7.

Maze15 is a dark room. The printed name of Maze15 is "Maze". "This is part of a maze of twisty little passages, all alike."
Maze15 is in the Underground.
West of Maze15 is Maze14. South of Maze15 is Maze7. Southeast of Maze15 is Cyclops-Room.

Chapter 7 - Grating and Leaves

The pile of leaves is in Grating Clearing. "On the ground is a pile of leaves."
Understand "leaves" and "leaf" and "pile" as the pile of leaves.

[ZIL LEAVES-APPEAR: reveals grate when leaves are disturbed]
To reveal-grate-from-leaves (this is the leaves-appear rule):
	if the grate-revealed is false and the grate is not open:
		now the grate-revealed is true;
		now the grate is zil-visible.

Instead of burning the pile of leaves:
	if the player carries the pile of leaves:
		die saying "The leaves burn, and so do you.";
	reveal-grate-from-leaves;
	if the grate-revealed is true and the grate is not open:
		say "With the leaves moved, a grating is revealed.[line break]";
	remove the pile of leaves from play;
	say "The leaves burn."

Instead of cutting the pile of leaves:
	say "You rustle the leaves around, making quite a mess.";
	if the grate-revealed is false:
		reveal-grate-from-leaves;
		say "[line break]With the leaves moved, a grating is revealed."

Instead of pushing the pile of leaves:
	say "Done.";
	if the grate-revealed is false:
		reveal-grate-from-leaves;
		say "[line break]In disturbing the pile of leaves, a grating is revealed."

Instead of taking the pile of leaves:
	if the grate-revealed is false:
		reveal-grate-from-leaves;
		say "In disturbing the pile of leaves, a grating is revealed.[line break]";
	continue the action.

Instead of looking under the pile of leaves:
	if the grate-revealed is false:
		say "Underneath the pile of leaves is a grating. As you release the leaves, the grating is once again concealed from view.";
	otherwise:
		say "There is nothing else under the leaves."

Chapter 8 - Cyclops-Room, Strange Passage, Treasure Room

Cyclops-Room is a dark room. Cyclops-Room is in the Underground.
The printed name of Cyclops-Room is "Cyclops Room".

The description of Cyclops-Room is "This room has an exit on the northwest, and a staircase leading up.[paragraph break][if the magic-flag is true]The east wall, previously solid, now has a cyclops-sized opening in it.[otherwise if the cyclops-asleep is true]The cyclops is sleeping blissfully at the foot of the stairs.[otherwise if the cyclops is in Cyclops-Room and the cyclops-wrath is 0]A cyclops, who looks prepared to eat horses (much less mere adventurers), blocks the staircase. From his state of health, and the bloodstains on the walls, you gather that he is not very friendly, though he likes people.[otherwise if the cyclops is in Cyclops-Room and the cyclops-wrath > 0]The cyclops is standing in the corner, eyeing you closely. I don't think he likes you very much. He looks extremely hungry, even for a cyclops.[otherwise if the cyclops is in Cyclops-Room and the cyclops-fed is true]The cyclops, having eaten the hot peppers, appears to be gasping. His enflamed tongue protrudes from his man-sized mouth.[end if]".

Instead of going east in Cyclops-Room:
	if the magic-flag is true:
		move the player to Strange Passage;
	otherwise:
		say "The east wall is solid rock."

Instead of going up in Cyclops-Room:
	if the cyclops-flag is true:
		move the player to Treasure Room;
		if the treasure-room-visited is false:
			now the treasure-room-visited is true;
			increase the score by 25;
	otherwise:
		say "The cyclops doesn[apostrophe]t look like he'll let you past."

Strange Passage is a dark room. "This is a long passage. To the west is one entrance. On the east there is an old wooden door, with a large opening in it (about cyclops sized)."
Strange Passage is in the Underground.
West of Strange Passage is Cyclops-Room. East of Strange Passage is Living Room.

Treasure Room is a dark room. "This is a large room, whose east wall is solid granite. A number of discarded bags, which crumble at your touch, are scattered about on the floor. There is an exit down a staircase."
Treasure Room is in the Underground.
Down from Treasure Room is Cyclops-Room.

Chapter 9 - Cyclops NPC

The cyclops is a person in Cyclops-Room.
Understand "cyclops" and "monster" and "eye" and "hungry" and "giant" as the cyclops.
Rule for writing a paragraph about the cyclops: now the cyclops is mentioned.
The description of the cyclops is "A hungry cyclops is blocking the staircase, looking at you as if you were a potential meal."

The cyclops-fed is a truth state that varies. The cyclops-fed is false.
The cyclops-watered is a truth state that varies. The cyclops-watered is false.
The cyclops-asleep is a truth state that varies. The cyclops-asleep is false.
The cyclops-wrath is a number that varies. The cyclops-wrath is 0.
The cyclops-wrath-timer is a number that varies. The cyclops-wrath-timer is 0.

Instead of giving the lunch to the cyclops:
	if the cyclops-asleep is true:
		say "No use. He's fast asleep.";
	otherwise:
		remove the lunch from play;
		now the cyclops-fed is true;
		decrease the cyclops-wrath by 1;
		now the cyclops-wrath-timer is 1;
		say "The cyclops says [quotation mark]Mmm Mmm. I love hot peppers! But oh, could I use a drink. Perhaps I could drink the blood of that thing.[quotation mark] From the gleam in his eye, it could be surmised that you are [quotation mark]that thing.[quotation mark]"

Instead of giving the quantity of water to the cyclops:
	if the cyclops-asleep is true:
		say "No use. He's fast asleep.";
	otherwise if the cyclops-fed is false:
		say "The cyclops apparently is not thirsty and refuses your generous offer.";
	otherwise:
		remove the quantity of water from play;
		now the cyclops-watered is true;
		now the cyclops-asleep is true;
		now the cyclops-flag is true;
		say "The cyclops takes the bottle, checks that it's open, and drinks the water. A moment later, he lets out a yawn that nearly blows you over, and then falls fast asleep (what did you put in that drink, anyway?)."

Instead of giving the glass bottle to the cyclops when the quantity of water is in the glass bottle:
	if the cyclops-asleep is true:
		say "No use. He's fast asleep.";
	otherwise if the cyclops-fed is false:
		say "The cyclops apparently is not thirsty and refuses your generous offer.";
	otherwise:
		remove the quantity of water from play;
		now the cyclops-watered is true;
		now the cyclops-asleep is true;
		now the cyclops-flag is true;
		say "The cyclops takes the bottle, checks that it's open, and drinks the water. A moment later, he lets out a yawn that nearly blows you over, and then falls fast asleep (what did you put in that drink, anyway?)."

Instead of giving something to the cyclops:
	if the cyclops-asleep is true:
		say "No use. He's fast asleep.";
	otherwise if the noun is the clove of garlic:
		say "The cyclops may be hungry, but there is a limit.";
	otherwise if the noun is not the lunch and the noun is not the quantity of water and the noun is not the glass bottle:
		say "The cyclops is not so stupid as to eat THAT!"

Instead of attacking the cyclops:
	if the cyclops-asleep is true:
		say "The cyclops yawns and stares at the thing that woke him up.";
		now the cyclops-asleep is false;
		now the cyclops-flag is false;
	otherwise:
		increase the cyclops-wrath by 1;
		now the cyclops-wrath-timer is 1;
		say "The cyclops shrugs but otherwise ignores your pitiful attempt."

Instead of telling the cyclops about something:
	if the cyclops-asleep is true:
		say "No use talking to him. He[apostrophe]s fast asleep.";
	otherwise:
		say "The cyclops prefers eating to making conversation."

Instead of examining the cyclops when the cyclops-asleep is true:
	say "The cyclops is sleeping like a baby, albeit a very ugly one."

Instead of pushing the cyclops:
	say "[quotation mark]Do you think I[apostrophe]m as stupid as my father was?[quotation mark], he says, dodging."

Instead of taking the cyclops:
	say "The cyclops doesn[apostrophe]t take kindly to being grabbed."

Instead of tying the cyclops to something:
	say "You cannot tie the cyclops, though he is fit to be tied."

Instead of listening to the cyclops:
	say "You can hear his stomach rumbling."

Every turn when the cyclops-wrath-timer > 0 and the player is in Cyclops-Room and the cyclops-asleep is false (this is the cyclops wrath rule):
	increase the cyclops-wrath-timer by 1;
	if the cyclops-wrath > 5 or the cyclops-wrath < -5:
		die saying "The cyclops, tired of all of your games and trickery, grabs you firmly. As he licks his chops, he says [quotation mark]Mmm. Just like Mom used to make [apostrophe]em.[quotation mark] It[apostrophe]s nice to be appreciated.";
	otherwise if the cyclops-wrath > 0:
		if the cyclops-wrath is 1:
			say "The cyclops seems somewhat agitated.";
		otherwise if the cyclops-wrath is 2:
			say "The cyclops appears to be getting more agitated.";
		otherwise if the cyclops-wrath is 3:
			say "The cyclops is moving about the room, looking for something.";
		otherwise if the cyclops-wrath is 4:
			say "The cyclops was looking for salt and pepper. No doubt they are condiments for his upcoming snack.";
		otherwise:
			say "You have two choices: 1. Leave  2. Become dinner.";
	otherwise if the cyclops-wrath < 0:
		say "The cyclops, having eaten the hot peppers, appears to be gasping. His enflamed tongue protrudes from his man-sized mouth."

Odysseusing is an action applying to nothing.
Understand "odysseus" and "ulysses" as odysseusing.

Carry out odysseusing:
	if the player is in Cyclops-Room and the cyclops is in Cyclops-Room and the cyclops-asleep is false:
		play the sound of footsteps-sfx as sfx;
		say "The cyclops, hearing the name of his father's deadly nemesis, flees the room by knocking down the wall on the east of the room.";
		remove the cyclops from play;
		now the cyclops-flag is true;
		now the magic-flag is true;
	otherwise if the player is in Cyclops-Room and the cyclops-asleep is true:
		say "The cyclops is asleep and can't hear you.";
	otherwise:
		say "Wasn't he a sailor?"

The chalice is in Treasure Room. "There is a silver chalice, intricately engraved, here."
Understand "chalice" and "cup" and "silver" as the chalice.
The description of the chalice is "It's a beautifully engraved silver chalice."
The treasure-value of the chalice is 5.
The point-value of the chalice is 10.

Instead of inserting something into the chalice:
	say "You can[apostrophe]t. It[apostrophe]s not a very good chalice, is it?"

Instead of taking the chalice when the player is in Treasure Room and the thief is not defeated and the thief is in Treasure Room:
	say "You[apostrophe]d be stabbed in the back first."

Chapter 10 - East-West Passage and Round Room Area

East-West Passage is a dark room. "This is a narrow east-west passageway. There is a narrow stairway leading down at the north end of the room."
East-West Passage is in the Underground.

East of Troll-Room is nowhere. [blocked by troll check - handled by instead rule]
East of East-West Passage is Round Room. West of East-West Passage is Troll-Room. Down from East-West Passage is Chasm.
North of East-West Passage is Chasm.

Round Room is a dark room. "This is a circular stone room with passages in all directions. Several of them have unfortunately been blocked by cave-ins."
Round Room is in the Underground.
East of Round Room is Loud Room. North of Round Room is North-South Passage. South of Round Room is Narrow Passage. Southeast of Round Room is Engravings Cave.

Chapter 11 - Dam and Reservoir Area

Deep Canyon is a dark room. "You are on the south edge of a deep canyon. Passages lead off to the east, northwest and southwest. A stairway leads down. [if the gates-open is true and the low-tide is false]You can hear a loud roaring sound, like that of rushing water, from below.[otherwise if the gates-open is false and the low-tide is true][otherwise]You can hear the sound of flowing water from below.[end if]".
Deep Canyon is in the Underground.
Northwest of Deep Canyon is Reservoir-South. East of Deep Canyon is Dam-Room. Southwest of Deep Canyon is North-South Passage. Down from Deep Canyon is Loud Room.

Loud Room is a dark room. Loud Room is in the Underground.
East of Loud Room is Damp Cave. West of Loud Room is Round Room. Up from Loud Room is Deep Canyon.

The loud-room-quiet is a truth state that varies. The loud-room-quiet is false.

The description of Loud Room is "This is a large room with a ceiling which cannot be detected from the ground. There is a narrow passage from east to west and a stone stairway leading upward.[if the loud-room-quiet is true or (the gates-open is false and the low-tide is true)] The room is eerie in its quietness.[otherwise] The room is deafeningly loud with an undetermined rushing sound. The sound seems to reverberate from all of the walls, making it difficult even to think.[end if]".

The platinum bar is in Loud Room. "On the ground is a large platinum bar."
Understand "bar" and "platinum" and "large" as the platinum bar.
The treasure-value of the platinum bar is 5.
The point-value of the platinum bar is 10.

Instead of taking the platinum bar when the loud-room-quiet is false:
	say "The acoustics of the room change as the platinum bar is carried through it. Unfortunately, the unpleasant consequences of this action are that the room now reflects sound more perfectly, and the painful clanging increases to an unbearable level. You stagger and drop the bar, and run from the room.";
	move the player to Round Room.

Echoing is an action applying to nothing.
Understand "echo" as echoing.

Carry out echoing:
	if the player is in Loud Room:
		if the loud-room-quiet is false:
			now the loud-room-quiet is true;
			say "The acoustics of the room change subtly.";
		otherwise:
			say "echo echo ...";
	otherwise:
		say "echo echo ..."

Every turn when the player is in Loud Room and the gates-open is true and the low-tide is false (this is the loud room ejection rule):
	say "It is unbearably loud here, with an ear-splitting roar seeming to come from all around you. There is a pounding in your head which won't stop. With a tremendous effort, you scramble out of the room.";
	let roll be a random number between 1 and 3;
	if roll is 1:
		move the player to Round Room;
	otherwise if roll is 2:
		move the player to Damp Cave;
	otherwise:
		move the player to Deep Canyon.

Damp Cave is a dark room. "This cave has exits to the west and east, and narrows to a crack toward the south. The earth is particularly damp here."
Damp Cave is in the Underground.

The damp-crack is scenery in Damp Cave. The printed name of the damp-crack is "crack".
Understand "crack" and "narrow" as the damp-crack.
The description of the damp-crack is "The crack is very narrow."
Instead of entering the damp-crack: say "You can't fit through the crack."

Instead of going south in Damp Cave:
	say "It is too narrow for most insects."

North-South Passage is a dark room. "This is a high north-south passage, which forks to the northeast."
North-South Passage is in the Underground.
North of North-South Passage is Chasm. Northeast of North-South Passage is Deep Canyon. South of North-South Passage is Round Room.

Chasm is a dark room. The printed name of Chasm is "Chasm". "A chasm runs southwest to northeast and the path follows it. You are on the south side of the chasm, where a crack opens into a passage."
Chasm is in the Underground.
Northeast of Chasm is Reservoir-South. Southwest of Chasm is East-West Passage. Up from Chasm is East-West Passage. South of Chasm is North-South Passage.

Instead of going down in Chasm:
	say "Are you out of your mind?"

The chasm-pseudo is a backdrop. The chasm-pseudo is in East-of-Chasm, Reservoir-South, and Chasm.
The printed name of the chasm-pseudo is "chasm".
Understand "chasm" and "abyss" as the chasm-pseudo.
The description of the chasm-pseudo is "The chasm is deep and impassable."

Crossing is an action applying to one thing. Understand "cross [something]" and "cross over [something]" as crossing.
Carry out crossing: say "You can't cross that!"

Instead of jumping when the player is in East-of-Chasm or the player is in Chasm:
	say "You look before leaping, and realize that you would never survive."

Instead of jumping in Dome Room:
	if the dome-flag is true:
		continue the action;
	say "This was not a very safe place to try jumping.";
	die saying "[jumploss]"

[ZIL V-LEAP: Kitchen chimney shaft — DOWN TO STUDIO IF FALSE-FLAG (always blocked)]
Instead of jumping in Kitchen:
	say "This was not a very safe place to try jumping.";
	die saying "[jumploss]"

[ZIL V-LEAP: Altar — DOWN TO TINY-CAVE IF COFFIN-CURE (blocked when carrying coffin)]
Instead of jumping in South Temple:
	if the player carries the gold coffin:
		say "This was not a very safe place to try jumping.";
		die saying "[jumploss]";
	continue the action.

[ZIL V-LEAP: Up-a-Tree — special non-fatal case, safely jump down]
Instead of jumping in Up a Tree:
	say "In a feat of unaccustomed daring, you manage to land on your feet without killing yourself.";
	try going down.

Instead of jumping in Canyon View:
	die saying "Nice view, lousy place to jump."

Instead of crossing the chasm-pseudo:
	say "It's too far to jump, and there's no bridge."

Instead of inserting something into the chasm-pseudo:
	say "The [noun] drops out of sight into the chasm.";
	remove the noun from play.

Reservoir-South is a dark room. The printed name of Reservoir-South is "Reservoir South". Reservoir-South is in the Underground.
The description of Reservoir-South is "[if the low-tide is true and the gates-open is true]You are in a long room, to the north of which was formerly a lake. However, with the water level lowered, there is merely a wide stream running through the center of the room.[otherwise if the gates-open is true]You are in a long room. To the north is a large lake, too deep to cross. You notice, however, that the water level appears to be dropping at a rapid rate. Before long, it might be possible to cross to the other side from here.[otherwise if the low-tide is true]You are in a long room, to the north of which is a wide area which was formerly a reservoir, but now is merely a stream. You notice, however, that the level of the stream is rising quickly and that before long it will be impossible to cross here.[otherwise]You are in a long room on the south shore of a large lake, far too deep and wide for crossing.[end if][paragraph break]There is a path along the stream to the east or west, a steep pathway climbing southwest along the edge of a chasm, and a path leading into a canyon to the southeast.".

Southeast of Reservoir-South is Deep Canyon.

The lake-pseudo is a backdrop. The lake-pseudo is in Reservoir-South and Reservoir-North.
The printed name of the lake-pseudo is "lake".
Understand "lake" and "reservoir" as the lake-pseudo when the player is in Reservoir-South or the player is in Reservoir-North.
The description of the lake-pseudo is "[if the low-tide is true]There's not much lake left....[otherwise]The lake stretches out before you.[end if]"

Instead of crossing the lake-pseudo:
	say "It's too wide to cross."

Instead of entering the lake-pseudo:
	say "You can't swim in this lake."

Instead of swimming when the player is in Reservoir-South or the player is in Reservoir-North:
	say "You can't swim in this lake."
East of Reservoir-South is Dam-Room. West of Reservoir-South is Stream View.
Southwest of Reservoir-South is Chasm.

Instead of going north in Reservoir-South:
	if the low-tide is true:
		move the player to Reservoir;
	otherwise:
		say "You would drown."

Dam-Room is a dark room. The printed name of Dam-Room is "Dam".
Dam-Room is in the Underground.
The description of Dam-Room is "You are standing on the top of Flood Control Dam #3, which was quite a tourist attraction in times far distant. There are paths to the north, south, and west, and a scramble down.[paragraph break][if the low-tide is true and the gates-open is true]The water level behind the dam is low: The sluice gates have been opened. Water rushes through the dam and downstream.[otherwise if the gates-open is true]The sluice gates are open, and water rushes through the dam. The water level behind the dam is still high.[otherwise if the low-tide is true]The sluice gates are closed. The water level in the reservoir is quite low, but the level is rising quickly.[otherwise]The sluice gates on the dam are closed. Behind the dam, there can be seen a wide reservoir. Water is pouring over the top of the now abandoned dam.[end if][paragraph break]There is a control panel here, on which a large metal bolt is mounted. Directly above the bolt is a small green plastic bubble[if the gate-flag is true] which is glowing serenely[end if]."
South of Dam-Room is Deep Canyon. Down from Dam-Room is Dam-Base. East of Dam-Room is Dam-Base. North of Dam-Room is Dam-Lobby.
West of Dam-Room is Reservoir-South.

The dam is scenery in Dam-Room. Understand "dam" and "gate" and "gates" and "fcd" and "fcd#3" and "fcd3" as the dam.
The description of the dam is "This is Flood Control Dam #3, quite an impressive engineering feat."
Instead of opening or closing the dam: say "Sounds reasonable, but this isn't how."
Instead of plugging the dam with something:
	if the second noun is the viscous material:
		say "Are you the little Dutch boy, then? Sorry, this is a big dam.";
	otherwise:
		say "With a [second noun]? Do you know how big this dam is? You could only stop a tiny leak with that."

The bolt is scenery in Dam-Room. Understand "bolt" and "nut" and "metal" and "large" as the bolt.
The description of the bolt is "It's a large metal bolt attached to the dam structure."
Instead of taking the bolt: say "It is an integral part of the control panel."

The green bubble is scenery in Dam-Room. Understand "bubble" and "small" and "green" and "plastic" as the green bubble.
The description of the green bubble is "A small green plastic bubble is floating in the stream."
Instead of taking the green bubble: say "It is an integral part of the control panel."

The control panel is scenery in Dam-Room. Understand "panel" and "control" as the control panel.
The description of the control panel is "The control panel is part of the dam infrastructure."

Dam-Lobby is a dark room. The printed name of Dam-Lobby is "Dam Lobby". "This room appears to have been the waiting room for groups touring the dam. There are open doorways here to the north and east marked 'Private', and there is a path leading south over the top of the dam."
Dam-Lobby is in the Underground.
South of Dam-Lobby is Dam-Room. North of Dam-Lobby is Maintenance Room. East of Dam-Lobby is Maintenance Room.

The tour guidebook is in Dam-Lobby. "Some guidebooks entitled 'Flood Control Dam #3' are on the reception desk."
Understand "guide" and "book" and "guidebooks" and "tour" as the tour guidebook.
The description of the tour guidebook is "[fixed letter spacing]   Flood Control Dam #3[line break][line break]FCD#3 was constructed in year 783 of the Great Underground Empire to harness the mighty Frigid River. This work was supported by a grant of 37 million zorkmids from your omnipotent local tyrant Lord Dimwit Flathead the Excessive. This impressive structure is composed of 370,000 cubic feet of concrete, is 256 feet tall at the center, and 193 feet wide at the top. The lake created behind the dam has a volume of 1.7 billion cubic feet, an area of 12 million square feet, and a shore line of 36 thousand feet.[line break][line break]The construction of FCD#3 took 112 days from ground breaking to the dedication. It required a work force of 384 slaves, 34 slave drivers, 12 engineers, 2 turtle doves, and a partridge in a pear tree. The work was managed by a command team composed of 2345 bureaucrats, 2347 secretaries (at least two of whom could type), 12,256 paper shufflers, 52,469 rubber stampers, 245,193 red tape processors, and nearly one million dead trees.[line break][line break]We will now point out some of the more interesting features of FCD#3 as we conduct you on a guided tour of the facilities:[line break][line break]      1) You start your tour here in the Dam-Lobby. You will notice on your right that....[variable letter spacing]"

The matchbook is in Dam-Lobby. "There is a matchbook whose cover says 'Visit Beautiful FCD#3' here."
Understand "match" and "matches" and "matchbook" as the matchbook.
The description of the matchbook is "The matchbook isn[apostrophe]t very interesting, except for what[apostrophe]s written on it."
The match-count is a number that varies. The match-count is 6.

Instead of examining the matchbook when the match-lit is true:
	say "The match is burning."

Reading is an action applying to one thing. Understand "read [something]" as reading.

Instead of reading the matchbook:
	say "[fixed letter spacing](Close cover before striking)[line break][line break]YOU too can make BIG MONEY in the exciting field of PAPER SHUFFLING![line break][line break]Mr. Anderson of Muddle, Mass. says: 'Before I took this course I was a lowly bit twiddler. Now with what I learned at GUE Tech I feel really important and can obfuscate and confuse with the best.'[line break][line break]Dr. Blank had this to say: 'Ten short days ago all I could look forward to was a dead-end job as a doctor. Now I have a promising future and make really big Zorkmids.'[line break][line break]GUE Tech can't promise these fantastic results to everyone. But when you earn your degree from GUE Tech, your future will be brighter.[variable letter spacing]"

Maintenance Room is a dark room. "This is what appears to have been the maintenance room for Flood Control Dam #3. Apparently, this room has been ransacked recently, for most of the valuable equipment is gone. On the wall in front of you is a group of buttons colored blue, yellow, brown, and red. There are doorways to the west and south."
Maintenance Room is in the Underground.
South of Maintenance Room is Dam-Lobby. West of Maintenance Room is Dam-Lobby.

The yellow button is scenery in Maintenance Room. Understand "yellow" and "button" as the yellow button.
The brown button is scenery in Maintenance Room. Understand "brown" and "button" as the brown button.
The red button is scenery in Maintenance Room. Understand "red" and "button" as the red button.
The blue button is scenery in Maintenance Room. Understand "blue" and "button" as the blue button.

Instead of examining the yellow button: say "They[apostrophe]re greek to you."
Instead of examining the brown button: say "They[apostrophe]re greek to you."
Instead of examining the red button: say "They[apostrophe]re greek to you."
Instead of examining the blue button: say "They[apostrophe]re greek to you."

Instead of pushing the yellow button:
	now the gate-flag is true;
	say "Click."

Instead of pushing the brown button:
	now the gate-flag is false;
	say "Click."

Instead of pushing the red button:
	say "The lights within the room come on."

The water-level is a number that varies. The water-level is 0.
The maint-flooded is a truth state that varies. The maint-flooded is false.

The leak is scenery. The leak is zil-invisible.
Understand "leak" and "pipe" and "pipes" and "stream" and "water" as the leak.
The description of the leak is "Water is pouring out of a crack in the east wall."

Instead of pushing the blue button:
	if the water-level is 0:
		now the water-level is 1;
		now the leak is zil-visible;
		now the leak is in Maintenance Room;
		say "There is a rumbling sound and a stream of water appears to burst from the east wall of the room (apparently, a leak has occurred in a pipe).";
	otherwise:
		say "The blue button appears to be jammed."

Plugging it with is an action applying to two things. Understand "plug [something] with [something]" and "fix [something] with [something]" and "patch [something] with [something]" as plugging it with.
Carry out plugging it with: say "That doesn't work."

Instead of plugging the leak with the viscous material:
	if the water-level > 0:
		now the water-level is -1;
		say "By some miracle of Zorkian technology, you have managed to stop the leak in the dam."

Instead of putting the viscous material on the leak:
	try plugging the leak with the viscous material.

Every turn when the water-level > 0 and the maint-flooded is false (this is the maintenance flooding rule):
	increase the water-level by 1;
	if the player is in Maintenance Room:
		if the water-level is 2:
			say "The water level here is now up to your ankles.[line break]";
		otherwise if the water-level is 4:
			say "The water level here is now up to your shin.[line break]";
		otherwise if the water-level is 6:
			say "The water level here is now up to your knees.[line break]";
		otherwise if the water-level is 8:
			say "The water level here is now up to your hips.[line break]";
		otherwise if the water-level is 10:
			say "The water level here is now up to your waist.[line break]";
		otherwise if the water-level is 12:
			say "The water level here is now up to your chest.[line break]";
		otherwise if the water-level is 13:
			say "The water level here is now up to your neck.[line break]";
	if the water-level is at least 14:
		now the maint-flooded is true;
		if the player is in Maintenance Room:
			die saying "I'm afraid you have done drowned yourself."

Instead of going to Maintenance Room when the maint-flooded is true:
	say "The room is full of water and cannot be entered." instead.

The tool chests are in Maintenance Room. "There is a group of tool chests here."
The tool chests are plural-named.
Understand "chest" and "chests" and "tool" and "toolchests" and "group" as the tool chests.
The description of the tool chests is "The chests are all empty."

Instead of taking the tool chests:
	remove the tool chests from play;
	say "The chests are so rusty and corroded that they crumble when you touch them."

Instead of opening the tool chests:
	remove the tool chests from play;
	say "The chests are so rusty and corroded that they crumble when you touch them."

Instead of inserting something into the tool chests:
	remove the tool chests from play;
	say "The chests are so rusty and corroded that they crumble when you touch them."

The wrench is in Maintenance Room. Understand "wrench" and "tool" as the wrench.
The description of the wrench is "It's a wrench."

The screwdriver is in Maintenance Room. Understand "screwdriver" and "tool" and "driver" as the screwdriver.
The description of the screwdriver is "It's a screwdriver."

The tube is in Maintenance Room. "There is an object which looks like a tube of toothpaste here."
Understand "tube" and "tooth" and "paste" as the tube.
The tube is a closed openable container. The carrying capacity of the tube is 1.
The description of the tube is "The label reads: 'Frobozz Magic Gunk Company --- All-Purpose Gunk'."

Instead of inserting something into the tube: say "The tube refuses to accept anything."

Instead of squeezing the tube:
	if the tube is open:
		if the viscous material is in the tube:
			now the player carries the viscous material;
			say "The viscous material oozes into your hand.";
		otherwise:
			say "The tube is apparently empty.";
	otherwise:
		say "The tube is closed."

The viscous material is in the tube. Understand "material" and "gunk" and "viscous" and "putty" as the viscous material.
The description of the viscous material is "It's a viscous, putty-like material."

The group of tool chests is scenery in Maintenance Room. Understand "chest" and "chests" and "group" and "toolchests" and "tool" as the group of tool chests.
The description of the group of tool chests is "The chests are all empty."
Instead of taking or opening the group of tool chests:
	remove the group of tool chests from play;
	say "The chests are so rusty and corroded that they crumble when you touch them."
Instead of inserting something into the group of tool chests:
	remove the group of tool chests from play;
	say "The chests are so rusty and corroded that they crumble when you touch them."

Chapter 12 - Reservoir Area

Reservoir is a dark room. Reservoir is in the Underground.
The description of Reservoir is "[if the low-tide is true]You are on what used to be a large lake, but which is now a large mud pile. There are [quotation mark]shores[quotation mark] to the north and south.[otherwise]You are on the lake. Beaches can be seen north and south. Upstream a small stream enters the lake through a narrow cleft in the rocks. The dam can be seen downstream.[end if]".
North of Reservoir is Reservoir-North. South of Reservoir is Reservoir-South.

Reservoir-North is a dark room. The printed name of Reservoir-North is "Reservoir North".
The description of Reservoir-North is "[if the low-tide is true and the gates-open is true]You are in a large cavernous room, the south of which was formerly a lake. However, with the water level lowered, there is merely a wide stream running through there.[otherwise if the gates-open is true]You are in a large cavernous area. To the south is a wide lake, whose water level appears to be falling rapidly.[otherwise if the low-tide is true]You are in a cavernous area, to the south of which is a very wide stream. The level of the stream is rising rapidly, and it appears that before long it will be impossible to cross to the other side.[otherwise]You are in a large cavernous room, north of a large lake.[end if][paragraph break]There is a slimy stairway leaving the room to the north."
Reservoir-North is in the Underground.
North of Reservoir-North is Atlantis Room.

Instead of going south in Reservoir-North:
	if the low-tide is true:
		move the player to Reservoir;
	otherwise:
		say "You would drown."

Stream View is a dark room. "You are standing on a path beside a gently flowing stream. The path follows the stream, which flows from west to east."
Stream View is in the Underground.
East of Stream View is Reservoir-South.

Instead of going west in Stream View:
	say "The stream emerges from a spot too small for you to enter."

The stream-pseudo is a backdrop. The stream-pseudo is in Stream View and In-Stream.
The printed name of the stream-pseudo is "stream".
Understand "stream" as the stream-pseudo.
The description of the stream-pseudo is "The stream flows gently from west to east."

Instead of entering the stream-pseudo:
	say "You can't swim in the stream."

Instead of crossing the stream-pseudo:
	say "The other side is a sheer rock cliff."

Instead of swimming when the player is in Stream View or the player is in In-Stream:
	say "You can't swim in the stream."

The hand-held air pump is in Reservoir-North. "There is a small pump here."
Understand "pump" and "air-pump" and "tool" and "small" and "hand-held" as the hand-held air pump.
The description of the hand-held air pump is "It's a small hand-held air pump."

Chapter 13 - Dam-Base and River

Dam-Base is a room. The printed name of Dam-Base is "Dam Base". "You are at the base of Flood Control Dam #3, which looms above you and to the north. The river Frigid is flowing by here. Along the river are the White Cliffs which seem to form giant walls stretching from north to south along the shores of the river as it winds its way downstream."
Dam-Base is in the Underground.
North of Dam-Base is Dam-Room. Up from Dam-Base is Dam-Room.

The pile of plastic is in Dam-Base. "There is a folded pile of plastic here which has a small valve attached."
Understand "boat" and "pile" and "plastic" and "valve" and "inflatable" as the pile of plastic.
The description of the pile of plastic is "It's a pile of folded plastic with a small valve attached."

Chapter 14 - Mirror Rooms and Connecting Passages

Mirror Room 1 is a dark room. The printed name of Mirror Room 1 is "Mirror Room".
Mirror Room 1 is in the Underground.
The description of Mirror Room 1 is "You are in a large square room with tall ceilings. On the south wall is an enormous mirror which fills the entire wall. There are exits on the other three sides of the room.[if the mirror-mung is true][line break]Unfortunately, the mirror has been destroyed by your recklessness.[end if]".
North of Mirror Room 1 is Cold Passage. West of Mirror Room 1 is Twisting Passage. East of Mirror Room 1 is Small Cave.

The mirror-mung is a truth state that varies. The mirror-mung is false.

The mirror-one is scenery in Mirror Room 1. The printed name of the mirror-one is "mirror". Understand "mirror" and "reflection" and "enormous" as the mirror-one.
The description of the mirror-one is "[if the mirror-mung is true]The mirror is broken into many pieces.[otherwise]There is an ugly person staring back at you.[end if]"

Mirror Room 2 is a dark room. The printed name of Mirror Room 2 is "Mirror Room".
Mirror Room 2 is in the Underground.
The description of Mirror Room 2 is "You are in a large square room with tall ceilings. On the south wall is an enormous mirror which fills the entire wall. There are exits on the other three sides of the room.[if the mirror-mung is true][line break]Unfortunately, the mirror has been destroyed by your recklessness.[end if]".
West of Mirror Room 2 is Winding-Passage. North of Mirror Room 2 is Narrow Passage. East of Mirror Room 2 is Tiny Cave.

The mirror-two is scenery in Mirror Room 2. The printed name of the mirror-two is "mirror". Understand "mirror" and "reflection" and "enormous" as the mirror-two.
The description of the mirror-two is "[if the mirror-mung is true]The mirror is broken into many pieces.[otherwise]There is an ugly person staring back at you.[end if]"

Mirror-rubbing it with is an action applying to two things. Understand "rub [something] with [something]" and "touch [something] with [something]" as mirror-rubbing it with.
Carry out mirror-rubbing it with: say "That doesn[apostrophe]t seem to do anything."

Instead of mirror-rubbing the mirror-one with something when the mirror-mung is false:
	say "You feel a faint tingling transmitted through the [second noun]."
Instead of mirror-rubbing the mirror-two with something when the mirror-mung is false:
	say "You feel a faint tingling transmitted through the [second noun]."

Instead of rubbing the mirror-one:
	say "There is a rumble from deep within the earth and the room shakes.";
	move the player to Mirror Room 2.

Instead of rubbing the mirror-two:
	say "There is a rumble from deep within the earth and the room shakes.";
	move the player to Mirror Room 1.

Instead of taking the mirror-one: say "The mirror is many times your size. Give up."
Instead of taking the mirror-two: say "The mirror is many times your size. Give up."

Instead of attacking the mirror-one:
	if the mirror-mung is true:
		say "Haven't you done enough damage already?";
	otherwise:
		say "You have broken the mirror. I hope you have a seven years['] supply of good luck handy.";
		now the mirror-mung is true;
		now the lucky-flag is false.

Instead of attacking the mirror-two:
	if the mirror-mung is true:
		say "Haven't you done enough damage already?";
	otherwise:
		say "You have broken the mirror. I hope you have a seven years['] supply of good luck handy.";
		now the mirror-mung is true;
		now the lucky-flag is false.

Small Cave is a dark room. The printed name of Small Cave is "Cave". "This is a tiny cave with entrances west and north, and a staircase leading down."
Small Cave is in the Underground.
North of Small Cave is Mirror Room 1. Down from Small Cave is Atlantis Room. South of Small Cave is Atlantis Room. West of Small Cave is Twisting Passage.

Tiny Cave is a dark room. The printed name of Tiny Cave is "Cave". "This is a tiny cave with entrances west and north, and a dark, forbidding staircase leading down."
Tiny Cave is in the Underground.
North of Tiny Cave is Mirror Room 2. West of Tiny Cave is Winding-Passage. Down from Tiny Cave is Entrance to Hades.

Every turn when the player is in Tiny Cave and the location of the pair of candles is Tiny Cave and the pair of candles is lit (this is the drafty cave candle rule):
	if a random chance of 50 in 100 succeeds:
		now the pair of candles is not lit;
		say "A gust of wind blows out your candles![line break]";
		if in darkness:
			say "It is now completely dark.[line break]".

Cold Passage is a dark room. "This is a cold and damp corridor where a long east-west passageway turns into a southward path."
Cold Passage is in the Underground.
South of Cold Passage is Mirror Room 1. West of Cold Passage is Slide Room.

Narrow Passage is a dark room. "This is a long and narrow corridor where a long north-south passageway briefly narrows even further."
Narrow Passage is in the Underground.
North of Narrow Passage is Round Room. South of Narrow Passage is Mirror Room 2.

Winding-Passage is a dark room. "This is a winding passage. It seems that there are only exits on the east and north."
The printed name of Winding-Passage is "Winding Passage".
Winding-Passage is in the Underground.
North of Winding-Passage is Mirror Room 2. East of Winding-Passage is Tiny Cave.

Twisting Passage is a dark room. "This is a winding passage. It seems that there are only exits on the east and north."
Twisting Passage is in the Underground.
North of Twisting Passage is Mirror Room 1. East of Twisting Passage is Small Cave.

Atlantis Room is a dark room. "This is an ancient room, long under water. There is an exit to the south and a staircase leading up."
Atlantis Room is in the Underground.
Up from Atlantis Room is Small Cave. South of Atlantis Room is Reservoir-North.

The crystal trident is in Atlantis Room. "On the shore lies Poseidon's own crystal trident."
Understand "trident" and "fork" and "crystal" and "poseidon" as the crystal trident.
The treasure-value of the crystal trident is 11.
The point-value of the crystal trident is 4.

Chapter 15 - Temple, Dome, Egypt, and Hades

Engravings Cave is a dark room. "You have entered a low cave with passages leading northwest and east."
Engravings Cave is in the Underground.
Northwest of Engravings Cave is Round Room. East of Engravings Cave is Dome Room.

The engraved wall is in Engravings Cave. "There are old engravings on the walls here."
Understand "wall" and "engravings" and "inscription" and "old" and "ancient" as the engraved wall.
The description of the engraved wall is "The engravings were incised in the living rock of the cave wall by an unknown hand. They depict, in symbolic form, the beliefs of the ancient Zorkers. Skillfully interwoven with the bas reliefs are excerpts illustrating the major religious tenets of that time. Unfortunately, a later age seems to have considered them blasphemous and just as skillfully excised them."

Dome Room is a dark room. Dome Room is in the Underground.
The description of Dome Room is "You are at the periphery of a large dome, which forms the ceiling of another room below. Protecting you from a precipitous drop is a wooden railing which circles the dome.[if the dome-flag is true][line break]Hanging down from the railing is a rope which ends about ten feet from the floor below.[end if]".
West of Dome Room is Engravings Cave.

The dome-pseudo is a backdrop. The dome-pseudo is in Dome Room and Torch-Room.
The printed name of the dome-pseudo is "dome".
Understand "dome" as the dome-pseudo.
The description of the dome-pseudo is "[if the player is in Dome Room]You are at the periphery of the dome, looking down.[otherwise]The dome forms the ceiling of the room far above you.[end if]"

Instead of kissing the dome-pseudo:
	say "No."

The wooden railing is scenery in Dome Room. Understand "railing" and "rail" and "wooden" as the wooden railing.
The description of the wooden railing is "It's a sturdy wooden railing, suitable for tying things to."

Instead of going down in Dome Room:
	if the dome-flag is true:
		move the player to Torch-Room;
	otherwise:
		say "You cannot go down without fracturing many bones."

After going to Dome Room when the player-is-dead is true:
	say "As you enter the dome you feel a strong pull as if from a wind drawing you over the railing and down.";
	move the player to Torch-Room.

Instead of tying the rope to the wooden railing:
	if the dome-flag is true:
		say "The rope is already tied to it.";
	otherwise:
		now the dome-flag is true;
		now the rope is in Dome Room;
		say "The rope drops over the side and comes within ten feet of the floor."

Rule for writing a paragraph about the rope when the dome-flag is true: do nothing.

Understand "tie [something] to [something]" as tying it to.
Carry out tying it to:
	say "You can't tie those things together."

Instead of tying the rope to something when the second noun is not the wooden railing:
	say "You can[apostrophe]t tie the rope to that."

Instead of tying-up something:
	if the noun is a person:
		say "The [noun] struggles and you cannot tie him up.";
	otherwise:
		say "Why would you tie up a [noun]?"

Instead of untieing the rope:
	if the dome-flag is true:
		now the dome-flag is false;
		say "The rope is now untied.";
	otherwise:
		say "It is not tied to anything."

Instead of dropping the rope in Dome Room when the dome-flag is false:
	now the rope is in Torch-Room;
	say "The rope drops gently to the floor below."

Instead of taking the rope when the dome-flag is true:
	say "The rope is tied to the railing."

Torch-Room is a dark room. The printed name of Torch-Room is "Torch Room".
The description of Torch-Room is "This is a large room with a prominent doorway leading to a down staircase. Above you is a large dome. Up around the edge of the dome (20 feet up) is a wooden railing. In the center of the room sits a white marble pedestal.[if the dome-flag is true][line break]A piece of rope descends from the railing above, ending some five feet above your head.[end if]".
Torch-Room is in the Underground.
South of Torch-Room is North Temple. Down from Torch-Room is North Temple.

Instead of going up in Torch-Room:
	say "You cannot reach the rope."

The pedestal is a supporter in Torch-Room. The pedestal is scenery.
Understand "pedestal" and "white" and "marble" as the pedestal.
The description of the pedestal is "It's a white marble pedestal."

The torch is a thing on the pedestal. The initial appearance of the torch is "Sitting on the pedestal is a flaming torch, made of ivory."
Understand "torch" and "ivory" and "flaming" as the torch.
The torch is lit. The description of the torch is "The torch is burning."

Instead of switching off the torch:
	say "You nearly burn your hand trying to extinguish the flame."

Instead of pouring the quantity of water on the torch:
	say "The water evaporates before it gets close."

Instead of touching the torch:
	say "You nearly burn your hand."

The treasure-value of the torch is 6.
The point-value of the torch is 14.

North Temple is a dark room. The printed name of North Temple is "Temple". "This is the north end of a large temple. On the east wall is an ancient inscription, probably a prayer in a long-forgotten language. Below the prayer is a staircase leading down. The west wall is solid granite. The exit to the north end of the room is through huge marble pillars."
North Temple is in the Underground.
Down from North Temple is Egypt Room. East of North Temple is Egypt Room. North of North Temple is Torch-Room.
Up from North Temple is Torch-Room.
South of North Temple is South Temple.

The brass bell is in North Temple.
Understand "bell" and "small" and "brass" as the brass bell.
The description of the brass bell is "It's a small brass bell."

The prayer is scenery in North Temple. Understand "prayer" and "inscription" and "ancient" and "old" as the prayer.
The description of the prayer is "The prayer is inscribed in an ancient script, rarely used today. It seems to be a philippic against small insects, absent-mindedness, and the picking up and dropping of small objects. The final verse consigns trespassers to the land of the dead. All evidence indicates that the beliefs of the ancient Zorkers were obscure."

South Temple is a dark room. The printed name of South Temple is "Altar". "This is the south end of a large temple. In front of you is what appears to be an altar. In one corner is a small hole in the floor which leads into darkness. You probably could not get back up it."
South Temple is in the Underground.
North of South Temple is North Temple.

Instead of going down in South Temple:
	if the player carries the gold coffin:
		say "You haven't a prayer of getting the coffin down there.";
	otherwise:
		move the player to Tiny Cave.

The altar is a supporter in South Temple. The altar is scenery.
Understand "altar" as the altar.
The description of the altar is "It's a massive stone altar."

The black book is on the altar. "On the altar is a large black book, open to page 569."
Understand "book" and "prayer" and "page" and "large" and "black" as the black book.
Instead of closing the black book:
	say "As hard as you try, the book cannot be closed."

Instead of opening the black book:
	say "The book is already open to page 569."

Understand "turn [something]" as turning.
Understand "turn page/pages of/in [something]" as turning.

Instead of turning the black book:
	say "Beside page 569, there is only one other page with any legible printing on it. Most of it is unreadable, but the subject seems to be the banishment of evil. Apparently, certain noises, lights, and prayers are efficacious in this regard."

Instead of burning the black book:
	remove the black book from play;
	die saying "A booming voice says [quotation mark]Wrong, cretin![quotation mark] and you notice that you have turned into a pile of dust. How, I can't imagine."

The description of the black book is "Commandment #12592[paragraph break]Oh ye who go about saying unto each: 'Hello sailor':[line break]Dost thou know the magnitude of thy sin before the gods?[line break]Yea, verily, thou shalt be ground between two stones.[line break]Shall the angry gods cast thy body into the whirlpool?[line break]Surely, thy eye shall be put out with a sharp stick![line break]Even unto the ends of the earth shalt thou wander and[line break]Unto the land of the dead shalt thou be sent at last.[line break]Surely thou shalt repent of thy cunning."

The pair of candles is on the altar. "On the two ends of the altar are burning candles."
Understand "candles" and "pair" and "burning" as the pair of candles.
The pair of candles is lit.
The description of the pair of candles is "[if the candles-burned-out is true]Alas, there's not much left of the candles. Certainly not enough to burn.[otherwise if the pair of candles is lit]The candles are burning.[otherwise]The candles are out.[end if]".

Egypt Room is a dark room. The printed name of Egypt Room is "Egyptian Room". "This is a room which looks like an Egyptian tomb. There is an ascending staircase to the west."
Egypt Room is in the Underground.
West of Egypt Room is North Temple. Up from Egypt Room is North Temple.

The gold coffin is in Egypt Room. "The solid-gold coffin used for the burial of Ramses II is here."
Understand "coffin" and "casket" and "solid" and "gold" as the gold coffin.
The gold coffin is a closed openable container.
The treasure-value of the gold coffin is 15.
The point-value of the gold coffin is 10.
The carrying capacity of the gold coffin is 5.

After opening the gold coffin when the sceptre is in the gold coffin and the sceptre is not handled:
	play the sound of coffin-sfx as sfx;
	say "The gold coffin opens.[line break]";
	say "A sceptre, possibly that of ancient Egypt itself, is in the coffin. The sceptre is ornamented with colored enamel, and tapers to a sharp point." instead.

Rule for writing a paragraph about the gold coffin when the gold coffin is open:
	say "The solid-gold coffin used for the burial of Ramses II is here.[line break]";
	if the sceptre is in the gold coffin and the sceptre is not handled:
		say "A sceptre, possibly that of ancient Egypt itself, is in the coffin. The sceptre is ornamented with colored enamel, and tapers to a sharp point.[line break]";
		now the sceptre is mentioned.

The sceptre is in the gold coffin. "A sceptre, possibly that of ancient Egypt itself, is in the coffin. The sceptre is ornamented with colored enamel, and tapers to a sharp point."
Understand "sceptre" and "scepter" and "sharp" and "egyptian" and "ancient" and "enameled" as the sceptre.
The sceptre is a weapon.
The treasure-value of the sceptre is 6.
The point-value of the sceptre is 4.

Entrance to Hades is a dark room.
The description of Entrance to Hades is "You are outside a large gateway, on which is inscribed[paragraph break]  Abandon every hope all ye who enter here![paragraph break]The gate is open; through it you can see a desolation, with a pile of mangled bodies in one corner. Thousands of voices, lamenting some hideous fate, can be heard.[if the lld-flag is false and the player-is-dead is false][line break]The way through the gate is barred by evil spirits, who jeer at your attempts to pass.[end if]".
Entrance to Hades is in the Underground.
Up from Entrance to Hades is Tiny Cave.

The hades-gate is scenery in Entrance to Hades. The printed name of the hades-gate is "gate".
Understand "gate" and "gates" and "gateway" as the hades-gate when the player is in Entrance to Hades.
The description of the hades-gate is "The gate is protected by an invisible force. It makes your teeth ache to touch it."
Instead of entering the hades-gate: try going south.
Instead of doing anything to the hades-gate:
	unless we are examining or we are entering:
		say "The gate is protected by an invisible force. It makes your teeth ache to touch it." instead.

Instead of going south in Entrance to Hades:
	if the lld-flag is true:
		move the player to Land of the Dead;
	otherwise:
		say "Some invisible force prevents you from passing through the gate."

Instead of going inside in Entrance to Hades:
	if the lld-flag is true:
		move the player to Land of the Dead;
	otherwise:
		say "Some invisible force prevents you from passing through the gate."

The ghosts is scenery in Entrance to Hades. The printed name of the ghosts is "ghosts".
Understand "ghosts" and "spirits" and "fiends" and "force" and "invisible" and "evil" as the ghosts.
The description of the ghosts is "You see a number of ghostly spirits swirling around."

Instead of attacking the ghosts:
	say "How can you attack a spirit with material objects?"

Instead of telling the ghosts about something:
	say "The spirits jeer loudly and ignore you."

Instead of taking or pushing or pulling or touching or rubbing the ghosts:
	say "You seem unable to interact with these spirits."

Exorcising is an action applying to one thing. Understand "exorcise [something]" and "banish [something]" as exorcising.
Carry out exorcising: say "What a bizarre concept!"

Instead of exorcising the ghosts:
	if the player carries the brass bell and the player carries the black book and the player carries the pair of candles:
		say "You must perform the ceremony.";
	otherwise:
		say "You aren[apostrophe]t equipped for an exorcism."

Land of the Dead is a dark room. The printed name of Land of the Dead is "Land of the Dead". "You have entered the Land of the Living Dead. Thousands of lost souls can be heard weeping and moaning. In the corner are stacked the remains of dozens of previous adventurers less fortunate than yourself. A passage exits to the north."
Land of the Dead is in the Underground.
North of Land of the Dead is Entrance to Hades.

The adventurer-bodies is scenery in Land of the Dead. The printed name of the adventurer-bodies is "bodies".
Understand "bodies" and "remains" and "adventurers" and "previous" as the adventurer-bodies.
The description of the adventurer-bodies is "The bodies are piled up in the corner."
Instead of taking the adventurer-bodies: say "A force keeps you from taking the bodies."
Instead of attacking or burning the adventurer-bodies:
	die saying "The voice of the guardian of the dungeon booms out from the darkness, [quotation mark]Your disrespect costs you your life![quotation mark] and places your head on a sharp pole."

The crystal skull is in Land of the Dead. "Lying in one corner of the room is a beautifully carved crystal skull. It appears to be grinning at you rather nastily."
Understand "skull" and "head" and "crystal" as the crystal skull.
The treasure-value of the crystal skull is 10.
The point-value of the crystal skull is 10.

Chapter 16 - Exorcism Ceremony

The xb-flag is a truth state that varies. The xb-flag is false.
The xc-flag is a truth state that varies. The xc-flag is false.
The xb-timer is a number that varies. The xb-timer is 0.
The hot-bell-timer is a number that varies. The hot-bell-timer is 0.

Ringing is an action applying to one thing. Understand "ring [something]" as ringing.
Carry out ringing: say "How, exactly, can you ring that?"

Bell-ringing it with is an action applying to two things. Understand "ring [something] with [something]" as bell-ringing it with.
Carry out bell-ringing it with: say "How, exactly, can you ring that?"

Instead of bell-ringing the red hot brass bell with something:
	if the second noun is the sack or the second noun is the book or the second noun is the bird's nest or the second noun is the pile of leaves or the second noun is the rope:
		say "The [second noun] burns and is consumed.";
		remove the second noun from play;
	otherwise:
		say "The heat from the bell is too intense."

The red hot brass bell is a thing. "On the ground is a red hot bell."
Understand "bell" and "hot" and "red" and "brass" as the red hot brass bell.
The description of the red hot brass bell is "It's a red hot brass bell."

Instead of taking the red hot brass bell:
	say "The bell is very hot and cannot be taken."

Instead of ringing the red hot brass bell:
	say "The bell is too hot to reach."

Instead of rubbing the red hot brass bell:
	say "The bell is too hot to touch."

Instead of touching the red hot brass bell:
	say "The heat from the bell is too intense."

Pouring it on is an action applying to two things. Understand "pour [something] on [something]" as pouring it on.
Carry out pouring it on: say "You can't pour that."

Instead of pouring the quantity of water on the red hot brass bell:
	remove the quantity of water from play;
	say "The water cools the bell and is evaporated.";
	now the hot-bell-timer is 0;
	remove the red hot brass bell from play;
	now the brass bell is in the location of the player.

Instead of ringing the brass bell:
	if the player is in Entrance to Hades and the lld-flag is false:
		now the xb-flag is true;
		now the xb-timer is 6;
		now the hot-bell-timer is 20;
		remove the brass bell from play;
		now the red hot brass bell is in Entrance to Hades;
		play the sound of bell-sfx as sfx;
		say "The bell suddenly becomes red hot and falls to the ground. The wraiths, as if paralyzed, stop their jeering and slowly turn to face you. On their ashen faces, the expression of a long-forgotten terror takes shape.";
		if the player carries the pair of candles:
			say "[line break]In your confusion, the candles drop to the ground (and they are out).";
			now the pair of candles is in Entrance to Hades;
			now the pair of candles is not lit;
	otherwise:
		say "Ding, dong."

Lighting-candles is an action applying to one thing.
Understand "light [something]" as lighting-candles when the noun is the pair of candles.

Instead of lighting-candles the pair of candles:
	if the candles-burned-out is true:
		say "Alas, there's not much left of the candles. Certainly not enough to burn.";
	otherwise if the pair of candles is lit:
		say "The candles are already lit.";
	otherwise if the match-lit is true:
		say "The candles are lit.";
		now the pair of candles is lit;
	otherwise if the player can see the torch:
		say "The heat from the torch is so intense that the candles are vaporized.";
		remove the pair of candles from play;
	otherwise:
		say "You should say what to light them with."

Instead of switching on the pair of candles: say "If you wish to burn the [noun], you should say so."

Instead of inserting the pair of candles into the sack:
	say "That wouldn[apostrophe]t be smart."

Instead of inserting the pair of candles into the bird's nest:
	say "That wouldn[apostrophe]t be smart."

Instead of switching off the pair of candles:
	if the pair of candles is lit:
		now the pair of candles is not lit;
		say "The flame is extinguished.";
		if in darkness:
			say " It's really dark in here....";
	otherwise:
		say "The candles are not lighted."

Every turn when the xb-flag is true and the player is in Entrance to Hades and the xc-flag is false (this is the candle flame power rule):
	if the player carries the pair of candles and the pair of candles is lit:
		now the xc-flag is true;
		say "The flames flicker wildly and appear to dance. The earth beneath your feet trembles, and your legs nearly buckle beneath you. The spirits cower at your unearthly power.[line break]";
		now the xb-timer is 0.

Every turn when the xb-timer > 0 (this is the xb timer rule):
	decrease the xb-timer by 1;
	if the xb-timer is 0 and the xc-flag is false:
		if the player is in Entrance to Hades:
			say "The tension of this ceremony is broken, and the wraiths, amused but shaken at your clumsy attempt, resume their hideous jeering.[line break]";
		now the xb-flag is false.

Every turn when the hot-bell-timer > 0 (this is the hot bell cooling rule):
	decrease the hot-bell-timer by 1;
	if the hot-bell-timer is 0:
		remove the red hot brass bell from play;
		now the brass bell is in Entrance to Hades;
		if the player is in Entrance to Hades:
			say "The bell appears to have cooled down.[line break]".

Instead of reading or examining the black book:
	if the xc-flag is true and the player is in Entrance to Hades and the lld-flag is false:
		now the lld-flag is true;
		remove the ghosts from play;
		play the sound of spirits-sfx as sfx;
		say "Each word of the prayer reverberates through the hall in a deafening confusion. As the last word fades, a voice, loud and commanding, speaks: [quotation mark]Begone, fiends![quotation mark] A heart-stopping scream fills the cavern, and the spirits, sensing a greater power, flee through the walls.";
	otherwise:
		say "[description of the black book]".

Chapter 17 - River and Falls Area

River1 is a room. The printed name of River1 is "Frigid River". "You are on the Frigid River in the vicinity of the Dam. The river flows quietly here. There is a landing on the west shore."
River1 is in the Underground.
West of River1 is Dam-Base. Down from River1 is River2.

The river-pseudo is a backdrop. The river-pseudo is in River1, River2, River3, River4, River5, Dam-Base, Shore, Sandy Beach, and Aragain Falls.
The printed name of the river-pseudo is "river".
Understand "river" and "frigid" and "frigid river" as the river-pseudo.
The description of the river-pseudo is "The Frigid River flows swiftly by."

Instead of inserting yourself into the river-pseudo:
	die saying "You splash around for a moment, then you drown."

Instead of inserting something into the river-pseudo:
	if the noun is the pile of leaves or the noun is the sack or the noun is the book or the noun is the bird's nest or the noun is the rope:
		say "The [noun] floats for a moment, then sinks.";
	otherwise:
		say "The [noun] splashes into the water and is gone forever.";
	remove the noun from play.

Instead of jumping when the player can see the river-pseudo and the player is not in the magic boat:
	say "A look before leaping reveals that the river is wide and dangerous, with swift currents and large, half-hidden rocks. You decide to forgo your swim."

The wclif-object is a backdrop. The wclif-object is in White Cliffs North, White Cliffs South, Dam-Base, River1, River2, River3, and River4.
The printed name of the wclif-object is "cliffs".
Understand "cliff" and "cliffs" and "white" as the wclif-object.
The description of the wclif-object is "The White Cliffs tower above you."
Instead of climbing the wclif-object: say "The cliff is too steep for climbing."

Instead of going up in River1:
	say "You cannot go upstream due to strong currents."

Instead of going east in River1:
	say "The White Cliffs prevent your landing here."

River2 is a room. The printed name of River2 is "Frigid River". "The river turns a corner here making it impossible to see the Dam. The White Cliffs loom on the east bank and large rocks prevent landing on the west."
River2 is in the Underground.
Down from River2 is River3.

Instead of going up in River2:
	say "You cannot go upstream due to strong currents."

Instead of going east in River2:
	say "The White Cliffs prevent your landing here."

Instead of going west in River2:
	say "Just in time you steer away from the rocks."

River3 is a room. The printed name of River3 is "Frigid River". "The river descends here into a valley. There is a narrow beach on the west shore below the cliffs. In the distance a faint rumbling can be heard."
River3 is in the Underground.
Down from River3 is River4. West of River3 is White Cliffs North.

Instead of going up in River3:
	say "You cannot go upstream due to strong currents."

White Cliffs North is a room. The printed name of White Cliffs North is "White Cliffs Beach". "You are on a narrow strip of beach which runs along the base of the White Cliffs. There is a narrow path heading south along the Cliffs and a tight passage leading west into the cliffs themselves."
White Cliffs North is in the Underground.

East of Damp Cave is White Cliffs North.

Instead of going south in White Cliffs North:
	if the player carries the pile of plastic or the player does not carry the magic boat:
		move the player to White Cliffs South instead;
	say "The path is too narrow with an inflated boat."

Instead of going west in White Cliffs North:
	if the player carries the pile of plastic or the player does not carry the magic boat:
		move the player to Damp Cave instead;
	say "The path is too narrow with an inflated boat."

White Cliffs South is a room. The printed name of White Cliffs South is "White Cliffs Beach". "You are on a rocky, narrow strip of beach beside the Cliffs. A narrow path leads north along the shore."
White Cliffs South is in the Underground.

Instead of going north in White Cliffs South:
	if the player carries the pile of plastic or the player does not carry the magic boat:
		move the player to White Cliffs North instead;
	say "The path is too narrow with an inflated boat."

River4 is a room. The printed name of River4 is "Frigid River". "The river is running faster here and the sound ahead appears to be that of rushing water. On the east shore is a sandy beach. A small area of beach can also be seen below the cliffs on the west shore."
River4 is in the Underground.
Down from River4 is River5. West of River4 is White Cliffs South. East of River4 is Sandy Beach.

Instead of going up in River4:
	say "You cannot go upstream due to strong currents."

River5 is a room. The printed name of River5 is "Frigid River". "The sound of rushing water is nearly unbearable here. On the east shore is a large landing area."
River5 is in the Underground.
East of River5 is Shore.

Instead of going up in River5:
	say "You cannot go upstream due to strong currents."

Instead of going down in River5:
	die saying "Unfortunately, the magic boat doesn't provide protection from the rocks and boulders one meets at the bottom of waterfalls. Including this one."

Section - River Current System

The river-current-timer is a number that varies. The river-current-timer is 0.
The river-current-active is a truth state that varies. The river-current-active is false.

Every turn when the river-current-active is true (this is the river current rule):
	let here be the location of the player;
	decrease the river-current-timer by 1;
	if the river-current-timer is at most 0:
		if here is River1:
			say "The flow of the river carries you downstream.[line break]";
			move the magic boat to River2;
			now the river-current-timer is 2;
			try looking;
		otherwise if here is River2:
			say "The flow of the river carries you downstream.[line break]";
			move the magic boat to River3;
			now the river-current-timer is 1;
			try looking;
		otherwise if here is River3:
			say "The flow of the river carries you downstream.[line break]";
			move the magic boat to River4;
			now the river-current-timer is 2;
			try looking;
		otherwise if here is River4:
			say "The flow of the river carries you downstream.[line break]";
			move the magic boat to River5;
			now the river-current-timer is 1;
			try looking;
		otherwise if here is River5:
			die saying "Unfortunately, the magic boat doesn't provide protection from the rocks and boulders one meets at the bottom of waterfalls. Including this one.";
		otherwise:
			now the river-current-active is false.

After going to River1:
	now the river-current-active is true;
	now the river-current-timer is 2;
	continue the action.

After going to River2:
	now the river-current-active is true;
	now the river-current-timer is 2;
	continue the action.

After going to River3:
	now the river-current-active is true;
	now the river-current-timer is 1;
	continue the action.

After going to River4:
	now the river-current-active is true;
	now the river-current-timer is 2;
	continue the action.

After going to River5:
	now the river-current-active is true;
	now the river-current-timer is 1;
	continue the action.

After going to Shore:
	now the river-current-active is false;
	continue the action.

After going to Sandy Beach:
	now the river-current-active is false;
	continue the action.

After going to White Cliffs North:
	now the river-current-active is false;
	continue the action.

After going to White Cliffs South:
	now the river-current-active is false;
	continue the action.

After going to Dam-Base:
	now the river-current-active is false;
	continue the action.

Shore is a room. "You are on the east shore of the river. The water here seems somewhat treacherous. A path travels from north to south here, the south end quickly turning around a sharp corner."
Shore is in the Underground.
North of Shore is Sandy Beach. South of Shore is Aragain Falls.

Sandy Beach is a room. "You are on a large sandy beach on the east shore of the river, which is flowing quickly by. A path runs beside the river to the south here, and a passage is partially buried in sand to the northeast."
Sandy Beach is in the Underground.
Northeast of Sandy Beach is Sandy Cave. South of Sandy Beach is Shore.

The shovel is in Sandy Beach. Understand "shovel" and "tool" as the shovel.
The description of the shovel is "It's a sturdy shovel."

Sandy Cave is a room. "This is a small, low-ceilinged cave nearly filled with fine white sand. The walls are rough limestone, worn smooth in places by ancient water. The only exit is a narrow passage to the southwest."
Sandy Cave is in the Underground.
Southwest of Sandy Cave is Sandy Beach.

The sand is scenery in Sandy Cave. Understand "sand" as the sand.
The description of the sand is "It's just sand."

The beautiful jeweled scarab is in Sandy Cave. The beautiful jeweled scarab is zil-invisible.
Understand "scarab" and "bug" and "beetle" and "beautiful" and "carved" and "jeweled" as the beautiful jeweled scarab.
The treasure-value of the beautiful jeweled scarab is 5.
The point-value of the beautiful jeweled scarab is 5.

The dig-count is a number that varies. The dig-count is 0.

Digging is an action applying to one thing. Understand "dig [something]" and "dig in [something]" as digging.
Carry out digging:
	say "The ground is too hard for digging here."

Instead of digging the sand:
	if the player does not carry the shovel:
		say "You need a shovel to dig here.";
	otherwise:
		increase the dig-count by 1;
		if the dig-count is 1:
			say "You seem to be digging a hole here.";
		otherwise if the dig-count is 2:
			say "The hole is getting deeper, but that[apostrophe]s about it.";
		otherwise if the dig-count is 3:
			say "You are surrounded by a wall of sand on all sides.";
		otherwise if the dig-count is 4:
			now the beautiful jeweled scarab is zil-visible;
			say "You can see a scarab here in the sand.";
			now the beautiful jeweled scarab is in Sandy Cave;
		otherwise:
			die saying "The hole collapses, smothering you."

Aragain Falls is a room.
The description of Aragain Falls is "You are at the top of Aragain Falls, an enormous waterfall with a drop of about 450 feet. The only path here is on the north end.[if the rainbow-flag is true][line break]A solid rainbow spans the falls.[otherwise][line break]A beautiful rainbow can be seen over the falls and to the west.[end if]".
Aragain Falls is in the Underground.

Instead of going west in Aragain Falls:
	if the rainbow-flag is true:
		move the player to On-the-Rainbow;
	otherwise:
		say "You can't go that way."

Instead of going down in Aragain Falls:
	say "It's a long way..."

On-the-Rainbow is a room. "You are on top of a rainbow (I bet you never thought you would walk on a rainbow), with a magnificent view of the Falls. The rainbow travels east-west here."
The printed name of On-the-Rainbow is "On the Rainbow".
On-the-Rainbow is in the Underground.
West of On-the-Rainbow is End of Rainbow. East of On-the-Rainbow is Aragain Falls.

End of Rainbow is a room. "You are on a small, rocky beach on the continuation of the Frigid River past the Falls. The beach is narrow due to the presence of the White Cliffs. The river canyon opens here and sunlight shines in from above. A rainbow crosses over the falls to the east and a narrow path continues to the southwest."
End of Rainbow is in the Underground.
Southwest of End of Rainbow is Canyon Bottom.

Instead of going east in End of Rainbow:
	if the rainbow-flag is true:
		move the player to On-the-Rainbow;
	otherwise:
		say "You can't go that way."

The pot of gold is in End of Rainbow. The pot of gold is zil-invisible. "At the end of the rainbow is a pot of gold."
Understand "pot" and "gold" as the pot of gold.
The treasure-value of the pot of gold is 10.
The point-value of the pot of gold is 10.

Canyon Bottom is a room. "You are beneath the walls of the river canyon which may be climbable here. The lesser part of the runoff of Aragain Falls flows by below. To the north is a narrow path."
Canyon Bottom is in the Underground.
Up from Canyon Bottom is Rocky Ledge. North of Canyon Bottom is End of Rainbow.

The climbable-cliff is a backdrop. The climbable-cliff is in Canyon Bottom, Rocky Ledge, and Canyon View.
The printed name of the climbable-cliff is "cliff".
Understand "cliff" and "wall" and "walls" and "climbable" as the climbable-cliff.
The description of the climbable-cliff is "The cliff is steep and rocky."
Instead of climbing the climbable-cliff: say "You can[apostrophe]t do that!"
Instead of jumping when the player can see the climbable-cliff and the player is not in Canyon View:
	say "That would be very unwise. Perhaps even fatal."

Rocky Ledge is a room. The printed name of Rocky Ledge is "Rocky Ledge". "You are on a ledge about halfway up the wall of the river canyon. You can see from here that the main flow from Aragain Falls twists along a passage which it is impossible for you to enter. Below you is the canyon bottom. Above you is more cliff, which appears climbable."
Rocky Ledge is in the Underground.
Up from Rocky Ledge is Canyon View. Down from Rocky Ledge is Canyon Bottom.

Canyon View is a room. "You are at the top of the Great Canyon on its west wall. From here there is a marvelous view of the canyon and parts of the Frigid River upstream. Across the canyon, the walls of the White Cliffs join the mighty ramparts of the Flathead Mountains to the east. Following the Canyon upstream to the north, Aragain Falls may be seen, complete with rainbow. The mighty Frigid River flows out from a great dark cavern. To the west and south can be seen an immense forest, stretching for miles around. A path leads northwest. It is possible to climb down into the canyon from here."
Canyon View is in the Underground.
East of Canyon View is Rocky Ledge. Down from Canyon View is Rocky Ledge.
Northwest of Canyon View is Clearing. West of Canyon View is Forest3.
East of Clearing is Canyon View.

Instead of going south in Canyon View:
	say "Storm-tossed trees block your way."

Chapter 18 - Sceptre and Rainbow

Carry out waving: say "You wave [the noun] around. Nothing happens."

Instead of waving the sceptre:
	if the player is in On-the-Rainbow:
		die saying "The structural integrity of the rainbow is severely compromised, leaving you hanging in midair, supported only by water vapor. Bye.";
	otherwise if the player is in Aragain Falls or the player is in End of Rainbow:
		if the rainbow-flag is false:
			now the rainbow-flag is true;
			now the pot of gold is zil-visible;
			say "Suddenly, the rainbow appears to become solid and, I venture, walkable (I think the giveaway was the stairs and bannister).";
			if the player is in End of Rainbow:
				say "[line break]A shimmering pot of gold appears at the end of the rainbow.";
		otherwise:
			now the rainbow-flag is false;
			now the pot of gold is zil-invisible;
			say "The rainbow seems to have become somewhat run-of-the-mill.";
	otherwise:
		say "A dazzling display of color briefly emanates from the sceptre."

The rainbow-object is a backdrop. The rainbow-object is in Aragain Falls, On-the-Rainbow, End of Rainbow, and Canyon View. The printed name of the rainbow-object is "rainbow".
Understand "rainbow" as the rainbow-object.
The description of the rainbow-object is "[if the rainbow-flag is true]The rainbow is solid and provides a colorful path across the Falls.[otherwise]The rainbow is a beautiful arc of colors spanning the Falls.[end if]"

Instead of entering the rainbow-object in Canyon View:
	say "From here?!?"

Instead of entering the rainbow-object in On-the-Rainbow:
	say "You[apostrophe]ll have to say which way..."

Instead of entering the rainbow-object:
	if the rainbow-flag is true:
		if the player is in Aragain Falls:
			move the player to On-the-Rainbow;
		otherwise if the player is in End of Rainbow:
			move the player to On-the-Rainbow;
	otherwise:
		say "Can you walk on water vapor?"

Instead of looking under the rainbow-object:
	say "The Frigid River flows under the rainbow."

Chapter 19 - Coal Mine Area

Mine Entrance is a dark room. "You are standing at the entrance of what might have been a coal mine. The shaft enters the west wall, and there is another exit on the south end of the room."
Mine Entrance is in the Underground.
South of Mine Entrance is Slide Room.

Squeaky Room is a dark room. "You are in a small room. Strange squeaky sounds may be heard coming from the passage at the north end. You may also escape to the east."
Squeaky Room is in the Underground.
West of Mine Entrance is Squeaky Room. East of Squeaky Room is Mine Entrance. North of Squeaky Room is Bat-Room.

Bat-Room is a dark room. Bat-Room is in the Underground.
The printed name of Bat-Room is "Bat Room".
South of Bat-Room is Squeaky Room. East of Bat-Room is Shaft Room.

The bat is a person in Bat-Room. The bat is scenery.
Understand "bat" and "vampire" and "deranged" as the bat.
The description of the bat is "[if the player encloses the clove of garlic]You can see a deranged vampire bat cowering in the corner, repelled by the garlic.[otherwise]A deranged vampire bat is swooping overhead.[end if]".

Instead of taking or attacking the bat:
	if the player encloses the clove of garlic or the clove of garlic is in Bat-Room:
		say "You can't reach him; he's on the ceiling.";
	otherwise:
		say "    Fweep![line break]    Fweep![line break]    Fweep![line break]".

Instead of telling the bat about something:
	say "    Fweep![line break]    Fweep![line break]    Fweep![line break]    Fweep![line break]    Fweep![line break]    Fweep!"

Instead of going north in Bat-Room:
	if the player carries the clove of garlic or the clove of garlic is in Bat-Room:
		continue the action;
	otherwise:
		play the sound of bat-sfx as sfx;
		say "    Fweep![line break]    Fweep![line break]    Fweep![line break][line break]The bat grabs you by the scruff of your neck and lifts you away....[paragraph break]";
		let R be a random number between 1 and 8;
		if R is 1:
			move the player to Mine1;
		otherwise if R is 2:
			move the player to Mine2;
		otherwise if R is 3:
			move the player to Mine3;
		otherwise if R is 4:
			move the player to Mine4;
		otherwise if R is 5:
			move the player to Ladder Top;
		otherwise if R is 6:
			move the player to Ladder Bottom;
		otherwise if R is 7:
			move the player to Squeaky Room;
		otherwise:
			move the player to Mine Entrance.

The description of Bat-Room is "You are in a small room which has doors only to the east and south. [if the clove of garlic is enclosed by the player]In the corner of the room on the ceiling is a large vampire bat who is obviously deranged and holding his nose.[otherwise]A large vampire bat, hanging from the ceiling, swoops down at you![end if]".

The jade figurine is in Bat-Room. "There is an exquisite jade figurine here."
Understand "figurine" and "jade" and "exquisite" as the jade figurine.
The treasure-value of the jade figurine is 5.
The point-value of the jade figurine is 5.

Shaft Room is a dark room. "This is a large room, in the middle of which is a small shaft descending through the floor into darkness below. To the west and the north are exits from this room. Constructed over the top of the shaft is a metal framework to which a heavy iron chain is attached."
Shaft Room is in the Underground.
West of Shaft Room is Bat-Room. North of Shaft Room is Smelly Room.

Instead of going down in Shaft Room:
	say "You wouldn't fit and would die if you could."

Smelly Room is a dark room. "This is a small nondescript room. However, from the direction of a small descending staircase a foul odor can be detected. To the south is a narrow tunnel."
Smelly Room is in the Underground.
Down from Smelly Room is Gas Room. South of Smelly Room is Shaft Room.

Gas Room is a dark room. "This is a small room which smells strongly of coal gas. There is a short climb up some stairs and a narrow tunnel leading east."
Gas Room is in the Underground.
Up from Gas Room is Smelly Room. East of Gas Room is Mine1.

The gas-pseudo is a backdrop. The gas-pseudo is in Gas Room and Smelly Room.
The printed name of the gas-pseudo is "gas".
Understand "gas" and "coal gas" and "odor" and "foul" and "smell" as the gas-pseudo.
The description of the gas-pseudo is "It smells like coal gas in here."

Blowing is an action applying to one thing. Understand "blow [something]" and "blow out [something]" as blowing.
Carry out blowing: say "You can't blow that."

Instead of blowing the gas-pseudo:
	say "There is too much gas to blow away."

Instead of smelling the gas-pseudo:
	say "It smells like coal gas in here."

Instead of switching on the torch when the player is in Gas Room:
	die saying "How sad for an aspiring adventurer to light a torch in a room which reeks of gas. Fortunately, there is justice in the world.[paragraph break]   ** BOOOOOOOOOOOM **"

Instead of burning the pair of candles when the player is in Gas Room:
	die saying "How sad for an aspiring adventurer to light candles in a room which reeks of gas. Fortunately, there is justice in the world.[paragraph break]   ** BOOOOOOOOOOOM **"

Instead of burning the matchbook when the player is in Gas Room:
	die saying "How sad for an aspiring adventurer to light a match in a room which reeks of gas. Fortunately, there is justice in the world.[paragraph break]   ** BOOOOOOOOOOOM **"

Every turn when the player is in Gas Room (this is the gas room explosion rule):
	if the torch is lit and the player carries the torch:
		die saying "Oh dear. It appears that the smell coming from this room was coal gas. I would have thought twice about carrying flaming objects in here.[paragraph break]   ** BOOOOOOOOOOOM **";
	if the pair of candles is lit and the player carries the pair of candles:
		die saying "Oh dear. It appears that the smell coming from this room was coal gas. I would have thought twice about carrying flaming objects in here.[paragraph break]   ** BOOOOOOOOOOOM **";
	if the match-lit is true:
		die saying "Oh dear. It appears that the smell coming from this room was coal gas. I would have thought twice about carrying flaming objects in here.[paragraph break]   ** BOOOOOOOOOOOM **".

The sapphire-encrusted bracelet is in Gas Room.
Understand "bracelet" and "jewel" and "sapphire" as the sapphire-encrusted bracelet.
The treasure-value of the sapphire-encrusted bracelet is 5.
The point-value of the sapphire-encrusted bracelet is 5.

Mine1 is a dark room. The printed name of Mine1 is "Coal Mine". "This is a nondescript part of a coal mine."
Mine1 is in the Underground.
North of Mine1 is Gas Room. East of Mine1 is Mine1. Northeast of Mine1 is Mine2.

Mine2 is a dark room. The printed name of Mine2 is "Coal Mine". "This is a nondescript part of a coal mine."
Mine2 is in the Underground.
North of Mine2 is Mine2. South of Mine2 is Mine1. Southeast of Mine2 is Mine3.

Mine3 is a dark room. The printed name of Mine3 is "Coal Mine". "This is a nondescript part of a coal mine."
Mine3 is in the Underground.
South of Mine3 is Mine3. Southwest of Mine3 is Mine4. East of Mine3 is Mine2.

Mine4 is a dark room. The printed name of Mine4 is "Coal Mine". "This is a nondescript part of a coal mine."
Mine4 is in the Underground.
North of Mine4 is Mine3. West of Mine4 is Mine4. Down from Mine4 is Ladder Top.

Ladder Top is a dark room. "This is a very small room. In the corner is a rickety wooden ladder, leading downward. It might be safe to descend. There is also a staircase leading upward."
Ladder Top is in the Underground.
Down from Ladder Top is Ladder Bottom. Up from Ladder Top is Mine4.

Ladder Bottom is a dark room. "This is a rather wide room. On one side is the bottom of a narrow wooden ladder. To the west and the south are passages leaving the room."
Ladder Bottom is in the Underground.
South of Ladder Bottom is Dead End 5. West of Ladder Bottom is Timber Room. Up from Ladder Bottom is Ladder Top.

Dead End 5 is a dark room. The printed name of Dead End 5 is "Dead End". "You have come to a dead end in the mine."
Dead End 5 is in the Underground.
North of Dead End 5 is Ladder Bottom.

The small pile of coal is in Dead End 5.
Understand "coal" and "pile" and "heap" and "small" as the small pile of coal.
The description of the small pile of coal is "It's a small pile of coal."

Timber Room is a dark room. "This is a long and narrow passage, which is cluttered with broken timbers. A wide passage comes from the east and turns at the west end of the room into a very narrow passageway. From the west comes a strong draft."
Timber Room is in the Underground.
East of Timber Room is Ladder Bottom.

Instead of going west in Timber Room when the player-is-dead is true:
	say "You cannot enter in your condition."

Instead of going west in Timber Room:
	let heavy-found be false;
	repeat with item running through things carried by the player:
		unless the item is the clove of garlic or the item is the matchbook:
			now heavy-found is true;
	if heavy-found is true:
		say "You cannot fit through this passage with that load.";
	otherwise:
		move the player to Drafty Room.

Drafty Room is a dark room. The printed name of Drafty Room is "Drafty Room". "This is a small drafty room in which is the bottom of a long shaft. To the south is a passageway and to the east a very narrow passage. In the shaft can be seen a heavy iron chain."
Drafty Room is in the Underground.
South of Drafty Room is Machine-Room.

Instead of going east in Drafty Room:
	let heavy-found be false;
	repeat with item running through things carried by the player:
		unless the item is the clove of garlic or the item is the matchbook:
			now heavy-found is true;
	if heavy-found is true:
		say "You cannot fit through this passage with that load.";
	otherwise:
		move the player to Timber Room.

The chain-pseudo is a backdrop. The chain-pseudo is in Shaft Room and Drafty Room.
The printed name of the chain-pseudo is "chain".
Understand "chain" and "iron" and "heavy" as the chain-pseudo.
The description of the chain-pseudo is "The chain secures a basket within the shaft."

Instead of taking or pushing or pulling the chain-pseudo:
	say "The chain is secure."

Instead of raising the chain-pseudo:
	say "Perhaps you should do that to the basket."

Instead of lowering the chain-pseudo:
	say "Perhaps you should do that to the basket."

The lowered-basket is in Drafty Room. The printed name of the lowered-basket is "basket". "From the chain is suspended a basket."
Understand "cage" and "dumbwaiter" and "basket" as the lowered-basket.

The raised-basket is an open container in Shaft Room. The printed name of the raised-basket is "basket". "At the end of the chain is a basket."
Understand "cage" and "dumbwaiter" and "basket" as the raised-basket.
The carrying capacity of the raised-basket is 10.

Instead of taking the raised-basket: say "The cage is securely fastened to the iron chain."
Instead of taking the lowered-basket: say "The cage is securely fastened to the iron chain."

The basket-is-at-top is a truth state that varies. The basket-is-at-top is true.

Raising is an action applying to one thing. Understand "raise [something]" as raising.
Carry out raising: say "You can't raise that."

Instead of raising the raised-basket:
	if the basket-is-at-top is true:
		say "[dummy]";
	otherwise:
		now the basket-is-at-top is true;
		now the raised-basket is in Shaft Room;
		now the lowered-basket is in Drafty Room;
		say "The basket is raised to the top of the shaft."

Instead of raising the lowered-basket:
	if the basket-is-at-top is true:
		say "[dummy]";
	otherwise:
		now the basket-is-at-top is true;
		now the raised-basket is in Shaft Room;
		now the lowered-basket is in Drafty Room;
		say "The basket is raised to the top of the shaft."

Lowering is an action applying to one thing. Understand "lower [something]" as lowering.
Carry out lowering: say "You can't lower that."

Instead of lowering the raised-basket:
	if the basket-is-at-top is false:
		say "[dummy]";
	otherwise:
		now the basket-is-at-top is false;
		now the raised-basket is in Drafty Room;
		now the lowered-basket is in Shaft Room;
		say "The basket is lowered to the bottom of the shaft."

Instead of lowering the lowered-basket:
	if the basket-is-at-top is false:
		say "[dummy]";
	otherwise:
		now the basket-is-at-top is false;
		now the raised-basket is in Drafty Room;
		now the lowered-basket is in Shaft Room;
		say "The basket is lowered to the bottom of the shaft."

Machine-Room is a dark room. "This is a large, cold room whose sole exit is to the north. In one corner there is a machine which is reminiscent of a clothes dryer. On its face is a switch which is labelled [quotation mark]START[quotation mark]. The switch does not appear to be manipulable by any human hand (unless the fingers are about 1/16 by 1/4 inch). On the front of the machine is a large lid, which is [if the machine is open]open[otherwise]closed[end if]."
The printed name of Machine-Room is "Machine Room".
Machine-Room is in the Underground.
North of Machine-Room is Drafty Room.

The machine is a closed openable container in Machine-Room. The machine is scenery.
Understand "machine" and "pdp10" and "dryer" and "lid" as the machine.
The carrying capacity of the machine is 5.
The description of the machine is "It's a large machine with a lid and a switch."

Instead of taking the machine: say "It is far too large to carry."
Instead of opening the machine when the machine is open: say "[dummy]".
Instead of closing the machine when the machine is not open: say "[dummy]".

The machine switch is scenery in Machine-Room. Understand "switch" as the machine switch.
The description of the machine switch is "It's a switch on the machine."

Does the player mean inserting something into the machine: it is very likely.

Instead of switching on the machine switch:
	if the player does not carry the screwdriver:
		say "It[apostrophe]s not clear how to turn it on with your bare hands." instead;
	if the machine is not closed:
		say "The machine must be closed first.";
	otherwise if the small pile of coal is in the machine:
		remove the small pile of coal from play;
		now the huge diamond is in the machine;
		play the sound of machine-sfx as sfx;
		say "The machine comes to life (figuratively) with a dazzling display of colored lights and bizarre noises. After a few moments, the excitement abates.";
	otherwise:
		let found-something be false;
		repeat with item running through things in the machine:
			now found-something is true;
			remove item from play;
			now the small piece of vitreous slag is in the machine;
		if found-something is true:
			play the sound of machine-sfx as sfx;
			say "The machine comes to life (figuratively) with a dazzling display of colored lights and bizarre noises. After a few moments, the excitement abates.";
		otherwise:
			say "The machine doesn[apostrophe]t seem to want to do anything."

The huge diamond is a thing. "There is an enormous diamond (perfectly cut) here."
Understand "diamond" and "huge" and "enormous" as the huge diamond.
The treasure-value of the huge diamond is 10.
The point-value of the huge diamond is 10.

The small piece of vitreous slag is a thing. Understand "gunk" and "piece" and "slag" and "small" and "vitreous" as the small piece of vitreous slag.
The description of the small piece of vitreous slag is "It's a small piece of vitreous slag."

Instead of taking the small piece of vitreous slag:
	say "The slag was rather insubstantial, and crumbles into dust at your touch.";
	remove the small piece of vitreous slag from play.

Instead of oiling the bolt:
	if the player carries the viscous material:
		say "Hmm. It appears the tube contained glue, not oil. Turning the bolt won't get any easier....";
	otherwise:
		say "You probably put spinach in your gas tank, too."

The granite-wall is a backdrop. The granite-wall is in Slide Room, North Temple, and Treasure Room.
The printed name of the granite-wall is "granite wall".
Understand "granite" and "wall" and "granite wall" as the granite-wall.
The description of the granite-wall is "[if the player is in Slide Room]It only SAYS [apostrophe]Granite Wall[apostrophe].[otherwise]The wall is solid granite here.[end if]".
Instead of taking or pushing or pulling the granite-wall:
	if the player is in Slide Room:
		say "The wall isn't granite.";
	otherwise:
		say "It's solid granite."

Slide Room is a dark room. "This is a small chamber, which appears to have been part of a coal mine. On the south wall of the chamber the letters 'Granite Wall' are etched in the rock. To the east is a long passage, and there is a steep metal slide twisting downward. To the north is a small opening."
Slide Room is in the Underground.
East of Slide Room is Cold Passage. North of Slide Room is Mine Entrance.

The slide-object is scenery in Slide Room. The printed name of the slide-object is "slide".
Understand "slide" and "metal" and "steep" as the slide-object.
The description of the slide-object is "It's a steep metal slide twisting downward."
Instead of entering the slide-object: try going down.
Instead of inserting something into the slide-object:
	if the noun is fixed in place:
		say "[yuks]";
	otherwise:
		say "The [noun] falls into the slide and is gone.";
		now the noun is in Cellar.

Instead of going down in Slide Room:
	say "You tumble down the slide....";
	move the player to Cellar.

The broken timber is in Timber Room.
Understand "timbers" and "pile" and "wooden" and "broken" as the broken timber.
The description of the broken timber is "They're just a pile of broken timbers."

Chapter 20 - Stone Barrow and Endgame

Stone Barrow is a room. "You are standing in front of a massive barrow of stone. In the east face is a huge stone door which is open. You cannot see into the dark of the tomb."
Northeast of Stone Barrow is West-of-House.

Instead of going southwest in West-of-House:
	if the won-flag is true:
		move the player to Stone Barrow;
	otherwise:
		say "You can't go that way."

The barrow-door is scenery in Stone Barrow. The printed name of the barrow-door is "stone door".
Understand "door" and "stone" and "huge" as the barrow-door.
The description of the barrow-door is "The door is a huge slab of stone."

The barrow-facade is scenery in Stone Barrow. The printed name of the barrow-facade is "barrow".
Understand "barrow" and "tomb" and "massive" as the barrow-facade.
The description of the barrow-facade is "It's a massive barrow of stone."
Instead of entering the barrow-facade: try going inside.
Instead of entering the barrow-door: try going inside.
Instead of opening the barrow-door: say "The door is too heavy."
Instead of closing the barrow-door: say "The door is too heavy."

Instead of going inside in Stone Barrow:
	say "Inside the Barrow[line break]As you enter the barrow, the door closes inexorably behind you. Around you it is dark, but ahead is an enormous cavern, brightly lit. Through its center runs a wide stream. Spanning the stream is a small wooden footbridge, and beyond a path leads into a dark tunnel. Above the bridge, floating in the air, is a large sign. It reads: All ye who stand before this bridge have completed a great and perilous adventure which has tested your wit and courage. You have mastered the first part of the ZORK trilogy. Those who pass over this bridge must be prepared to undertake an even greater adventure that will severely test your skill and bravery![paragraph break]The ZORK trilogy continues with 'ZORK II: The Wizard of Frobozz' and is completed in 'ZORK III: The Dungeon Master.'[line break]";
	end the story finally saying "Congratulations!"

Instead of going west in Stone Barrow:
	try going inside.

Chapter 21 - In-Stream

In-Stream is a room. The printed name of In-Stream is "Stream". "You are on the gently flowing stream. The upstream route is too narrow to navigate, and the downstream route is invisible due to twisting walls. There is a narrow beach to land on."
In-Stream is in the Underground.

Up from Reservoir is In-Stream. West of Reservoir is In-Stream.
Down from In-Stream is Reservoir. East of In-Stream is Reservoir.

Instead of going up in In-Stream:
	say "The channel is too narrow."

Instead of going west in In-Stream:
	say "The channel is too narrow."

Landing is an action applying to nothing. Understand "land" as landing.
Carry out landing:
	if the player is in In-Stream:
		move the player to Stream View;
	otherwise:
		say "You're not on the water."

Part 4 - The Thief

Chapter 1 - Thief NPC

The thief is a person. "There is a suspicious-looking individual, holding a bag, leaning against one wall. He is armed with a vicious-looking stiletto."
Understand "thief" and "robber" and "man" and "person" and "shady" and "suspicious" and "seedy" as the thief.
The thief is in Round Room.

The thief-strength is a number that varies. The thief-strength is 5.
The thief-unconscious is a truth state that varies. The thief-unconscious is false.

The large bag is carried by the thief. The large bag is a container. The carrying capacity of the large bag is 100.
Understand "bag" and "large" and "thief's" as the large bag.
The description of the large bag is "[if the thief is defeated]The bag is closed and you can[apostrophe]t see what[apostrophe]s inside.[otherwise]The bag is underneath the thief, so one can[apostrophe]t say what, if anything, is inside.[end if]"

The stiletto is carried by the thief. The stiletto is a weapon.
Understand "stiletto" and "vicious" as the stiletto.
The description of the stiletto is "It's a vicious-looking stiletto."

Instead of taking the stiletto when the thief is not defeated and the thief carries the stiletto:
	say "The thief swings it out of your reach."

Instead of taking the large bag:
	if the thief is defeated:
		continue the action;
	otherwise if the thief-unconscious is true:
		say "Sadly for you, the robber collapsed on top of the bag. Trying to take it would wake him.";
	otherwise:
		say "The bag will be taken over his dead body."

Instead of inserting something into the large bag:
	say "It would be a good trick."

Instead of opening the large bag:
	say "Getting close enough would be a good trick."

Instead of closing the large bag:
	say "Getting close enough would be a good trick."

The description of the thief is "The thief is a slippery character with beady eyes that flit back and forth. He carries, along with an unmistakable arrogance, a large bag over his shoulder and a vicious stiletto, whose blade is aimed menacingly in your direction. I[apostrophe]d watch out if I were you."

Instead of listening to the thief:
	say "The thief says nothing, as you have not been formally introduced."

Instead of taking the thief:
	say "Once you got him, what would you do with him?"

The thief-active is a truth state that varies. The thief-active is true.
The thief-here-count is a number that varies. The thief-here-count is 0.
The thief-engrossed is a truth state that varies. The thief-engrossed is false.
The thief-timer is a number that varies. The thief-timer is 0.

Every turn when the thief is not defeated and the thief-active is true (this is the thief daemon rule):
	increase the thief-timer by 1;
	if the thief-timer < 5:
		do nothing;
	otherwise:
		now the thief-timer is 0;
		let thief-room be the location of the thief;
		let player-room be the location of the player;
		if thief-room is player-room:
			[Thief encounters the player]
			if the player carries the clove of garlic:
				do nothing;
			otherwise if a random chance of 3 in 10 succeeds:
				[Rob the player of all valuables at 75% each]
				let stolen-any be false;
				let lost-light be false;
				repeat with item running through things carried by the player:
					if the treasure-value of item > 0:
						if a random chance of 3 in 4 succeeds:
							if item is lit:
								now lost-light is true;
							now item is in the large bag;
							now stolen-any is true;
				if stolen-any is true:
					play the sound of laugh-sfx as sfx;
					say "The thief just left, still carrying his large bag. You may not have noticed that he robbed you blind first.";
					if lost-light is true:
						say "[line break]The thief seems to have left you in the dark.";
				otherwise:
					say "The thief, finding nothing of value, left disgusted.";
				[Thief flees after encounter]
				let new-dest be a random dark room that is in the Underground;
				if new-dest is a room:
					move the thief to new-dest;
		otherwise:
			[Thief is in a room without the player - steal and move]
			repeat with item running through things in thief-room:
				if the treasure-value of item > 0:
					if a random chance of 3 in 4 succeeds:
						now item is in the large bag;
			[Move to a random underground room]
			let new-dest be a random dark room that is in the Underground;
			if new-dest is a room and new-dest is not player-room:
				move the thief to new-dest.

Every turn when the jewel-encrusted egg is in the large bag and the jewel-encrusted egg is closed (this is the thief opens egg rule):
	now the jewel-encrusted egg is open.

Before looking when the player is in Treasure Room and the thief is not defeated and the thief is not in Treasure Room (this is the thief lair rule):
	move the thief to Treasure Room;
	say "You hear a scream of anguish as you violate the robber[apostrophe]s hideaway. Using passages unknown to you, he rushes to its defense.";
	let found-treasure be false;
	repeat with item running through things in the Treasure Room:
		if item is not the thief and item is not the chalice and item is not the player:
			if the treasure-value of item > 0:
				now found-treasure is true;
				now item is zil-invisible;
	if found-treasure is true:
		say "[line break]The thief gestures mysteriously, and the treasures in the room suddenly vanish.[line break]".

Instead of answering the thief that "hello":
	if the thief is defeated:
		say "Unfortunately, the thief can[apostrophe]t hear you.";
	otherwise if the thief-unconscious is true:
		say "The thief, being temporarily incapacitated, is unable to acknowledge your greeting with his usual graciousness.";
	otherwise:
		say "The thief says nothing, as you have not been formally introduced."

Instead of telling the thief about something:
	if the thief is defeated:
		say "Unfortunately, the thief can[apostrophe]t hear you.";
	otherwise if the thief-unconscious is true:
		say "The thief, being temporarily incapacitated, is unable to respond.";
	otherwise:
		say "The thief is a strong, silent type."

Instead of giving something to the thief:
	if the thief is defeated:
		say "He's not exactly in a position to accept gifts.";
	otherwise:
		now the noun is in the large bag;
		if the treasure-value of the noun > 0:
			now the thief-engrossed is true;
			say "The thief is taken aback by your unexpected generosity, but accepts the [noun] and stops to admire its beauty.";
		otherwise:
			say "The thief places the [noun] in his bag and thanks you politely."

Instead of attacking the thief:
	if the thief is not in the location of the player:
		say "There is no thief here." instead;
	if the thief is defeated:
		say "The thief is already dead.";
	otherwise:
		let W be a random weapon carried by the player;
		if W is nothing:
			say "Trying to attack the thief with your bare hands is suicidal.";
		otherwise:
			now the melee-weapon is W;
			now the melee-target is the thief;
			let hit-chance be a random number between 1 and 10;
			if hit-chance is at least 3:
				decrease the thief-strength by 1;
				if the thief-strength is at most 0:
					now the thief is defeated;
					now the stiletto is in the location of the player;
					repeat with item running through things in the large bag:
						now item is in the location of the player;
					if the location of the player is Treasure Room:
						repeat with item running through zil-invisible things in the Treasure Room:
							now item is zil-visible;
						print hero melee for "kill";
						say "[line break][sinister-black-fog for the thief][paragraph break]As the thief dies, the power of his magic decreases, and his treasures reappear:";
						repeat with item running through things in the location of the player:
							if item is not the chalice and item is not the thief and item is not the player and item is not the large bag:
								say "[line break]  A [item]";
								if item is an open container and something is in item:
									say ", with ";
									let contents-count be 0;
									repeat with sub-item running through things in item:
										increase contents-count by 1;
									let printed be 0;
									repeat with sub-item running through things in item:
										increase printed by 1;
										if printed > 1 and printed is contents-count:
											say ", and ";
										otherwise if printed > 1:
											say ", ";
										say "a [sub-item]";
						say "[paragraph break]The chalice is now safe to take.";
					otherwise:
						print hero melee for "kill";
						say "[line break][sinister-black-fog for the thief]";
					remove the thief from play;
				otherwise:
					print hero melee for "light-wound";
			otherwise:
				print hero melee for "miss".

Chapter 2 - Sword Glow

The sword-glow-level is a number that varies. The sword-glow-level is 0.

To decide whether (V - a person) is a nearby villain:
	if V is in the location of the player, yes;
	no.

To decide whether a villain lurks adjacent:
	repeat with D running through directions:
		let R be the room D from the location of the player;
		if R is a room:
			if the troll is not defeated and the troll is in R, yes;
			if the thief is not defeated and the thief is in R, yes;
			if the cyclops is in R, yes;
	no.

Every turn when the player carries the sword (this is the sword glow rule):
	let danger-level be 0;
	if the troll is not defeated and the troll is a nearby villain:
		now danger-level is 2;
	if the thief is not defeated and the thief is a nearby villain:
		now danger-level is 2;
	if the cyclops is a nearby villain:
		now danger-level is 2;
	if danger-level is 0 and a villain lurks adjacent:
		now danger-level is 1;
	if danger-level is not the sword-glow-level:
		play the sound of sword-sfx as sfx;
		if danger-level is 0:
			say "Your sword is no longer glowing.";
		otherwise if danger-level is 1:
			say "Your sword is glowing with a faint blue glow.";
		otherwise:
			say "Your sword has begun to glow very brightly.";
		now the sword-glow-level is danger-level.

Instead of examining the sword:
	if the sword-glow-level is 1:
		say "Your sword is glowing with a faint blue glow.";
	otherwise if the sword-glow-level is 2:
		say "Your sword is glowing very brightly.";
	otherwise:
		continue the action.

Part 5 - Miscellaneous Actions and Rules

Chapter 1 - Hello Sailor

The hello-sailor-count is a number that varies. The hello-sailor-count is 0.

Hello-sailoring is an action applying to nothing. Understand "hello sailor" as hello-sailoring.
Carry out hello-sailoring:
	increase the hello-sailor-count by 1;
	if the remainder after dividing the hello-sailor-count by 20 is 0:
		say "You seem to be repeating yourself.";
	otherwise if the remainder after dividing the hello-sailor-count by 10 is 0:
		say "I think that phrase is getting a bit worn out.";
	otherwise:
		say "Nothing happens here."

Chapter 2 - Pray

Praying is an action applying to nothing. Understand "pray" as praying.
Carry out praying:
	if the player-is-dead is true:
		if the player is in South Temple:
			now the player-is-dead is false;
			now the always-lit-mode is false;
			if the troll is in Troll-Room:
				now the troll-flag is false;
				now the troll-unconscious is false;
				now the troll-recovery-chance is 0;
				if the bloody axe is in Troll-Room:
					now the troll carries the bloody axe;
			now the spirit-glow is nowhere;
			say "From the distance the sound of a lone trumpet is heard. The room becomes very bright and you feel disembodied. In a moment, the brightness fades and you find yourself rising as if from a long sleep, deep in the woods. In the distance you can faintly hear a songbird and the sounds of the forest.";
			move the player to Forest1;
		otherwise:
			say "Your prayers are not heard.";
	otherwise if the player is in South Temple:
		move the player to Forest1;
	otherwise:
		say "If you pray enough, your prayers may be answered."

Chapter 4 - Diagnose

Diagnosing is an action out of world. Understand "diagnose" as diagnosing.
Carry out diagnosing:
	if the player-is-dead is true:
		say "You are dead.";
		stop the action;
	say "You are in perfect health.[line break]";
	say "You can survive several wounds.[line break]";
	if the player-deaths > 0:
		say "You have been killed ";
		if the player-deaths is 1:
			say "once";
		otherwise:
			say "twice";
		say ".[line break]"

Chapter 4a - Self-Referential Actions

Instead of telling yourself about something:
	say "Talking to yourself is said to be a sign of impending mental collapse."

Instead of eating yourself:
	say "Auto-cannibalism is not the answer."

Instead of attacking yourself:
	let W be a random weapon carried by the player;
	if W is not nothing:
		die saying "If you insist.... Poof, you're dead!";
	otherwise:
		say "Suicide is not the answer."

Instead of pushing yourself:
	say "Why don't you just walk like normal people?"

Instead of taking yourself:
	say "How romantic!"

Instead of examining yourself:
	if the player is in Mirror Room 1 or the player is in Mirror Room 2:
		say "Your image in the mirror looks tired.";
	otherwise:
		say "That's difficult unless your eyes are prehensile."

Making is an action applying to one thing. Understand "make [something]" as making.
Carry out making: say "You can't make that."

Instead of making yourself:
	say "Only you can do that."

Chapter 5 - Rusty Knife Curse

Instead of taking the rusty knife when the player carries the sword:
	say "As you touch the rusty knife, your sword gives a single pulse of blinding blue light.";
	remove the rusty knife from play.

Instead of attacking a person when the player carries the rusty knife:
	say "As the knife approaches its victim, your mind is submerged by an overmastering will. Slowly, your hand turns, until the rusty blade is an inch from your neck. The knife seems to sing as it savagely slits your throat.";
	die saying ""

Every turn when the player carries the rusty knife and the player carries the sword (this is the rusty knife curse rule):
	say "As the rust of the knife reaches the sword, they react violently, and the rusty knife disintegrates.";
	remove the rusty knife from play.

Chapter 6 - Chimney Passage

Instead of going up in Studio:
	let items-carried be 0;
	repeat with item running through things carried by the player:
		increase items-carried by 1;
	if items-carried is 0:
		say "Going up empty-handed is a bad idea.";
	otherwise if items-carried > 2:
		say "You can't get up there with what you're carrying.";
	otherwise if the player carries the brass lantern and items-carried <= 2:
		move the player to Kitchen;
	otherwise:
		say "You can't get up there with what you're carrying."

Chapter 7 - Room Visit Points

The cellar-visited is a truth state that varies. The cellar-visited is false.
The kitchen-visited is a truth state that varies. The kitchen-visited is false.
The east-west-visited is a truth state that varies. The east-west-visited is false.
The treasure-room-visited is a truth state that varies. The treasure-room-visited is false.

After going to Cellar when the cellar-visited is false:
	now the cellar-visited is true;
	increase the score by 25;
	continue the action.

After going to Kitchen when the kitchen-visited is false:
	now the kitchen-visited is true;
	increase the score by 10;
	continue the action.

After going to East-West Passage when the east-west-visited is false:
	now the east-west-visited is true;
	increase the score by 5;
	continue the action.

After going to Treasure Room when the treasure-room-visited is false:
	now the treasure-room-visited is true;
	increase the score by 25;
	continue the action.

The light-shaft-bonus is a truth state that varies. The light-shaft-bonus is false.

After going to Drafty Room when the light-shaft-bonus is false and not in darkness:
	now the light-shaft-bonus is true;
	increase the score by 13;
	continue the action.

Chapter 8 - Ancient Map

The ancient map is in the trophy case. The ancient map is zil-invisible.
Understand "parchment" and "map" and "antique" and "old" and "ancient" as the ancient map.
The description of the ancient map is "The map shows a forest with three clearings. The largest clearing contains a house. Three paths leave the large clearing. One of these paths, leading southwest, is marked 'To Stone Barrow'."

Chapter 9 - Lurking Grue

The lurking grue is a backdrop. The lurking grue is everywhere.
Understand "grue" and "lurking" and "sinister" and "hungry" and "silent" as the lurking grue.
The description of the lurking grue is "The grue is a sinister, lurking presence in the dark places of the earth. Its favorite diet is adventurers, but its insatiable appetite is tempered by its fear of light. No grue has ever been seen by the light of day, and few have survived its fearsome jaws to tell the tale."

Instead of finding the lurking grue:
	say "There is no grue here, but I'm sure there is at least one lurking in the darkness nearby. I wouldn't let my light go out if I were you!"

Instead of listening to the lurking grue:
	say "It makes no sound but is always lurking in the darkness nearby."

Chapter 9a - Global Backdrops

The global-hands is a backdrop. The global-hands is everywhere.
The printed name of the global-hands is "pair of hands".
Understand "hands" and "hand" and "pair" as the global-hands.
Understand "bare" as the global-hands.
The description of the global-hands is "You have two normal-looking hands."

The global-lungs is a backdrop. The global-lungs is everywhere.
The printed name of the global-lungs is "blast of air".
Understand "lungs" and "air" and "mouth" and "breath" as the global-lungs.
The description of the global-lungs is "You have normal-looking lungs."

The global-stairs is a backdrop. The global-stairs is everywhere.
The printed name of the global-stairs is "stairs".
Understand "stairs" and "staircase" and "stairway" and "steps" as the global-stairs.
The description of the global-stairs is "The stairs lead up and down."

Instead of entering the global-stairs:
	say "You should say whether you want to go up or down."

Instead of climbing the global-stairs:
	say "You should say whether you want to go up or down."

The global-path is a backdrop. The global-path is in House Exterior, Forest Area, and Underground.
The printed name of the global-path is "path".
Understand "path" and "trail" as the global-path.
The description of the global-path is "The path leads in several directions."

Instead of taking the global-path:
	say "You must specify a direction to go."

Instead of finding the global-path:
	say "I can't help you there...."

Following is an action applying to one thing. Understand "follow [something]" as following.
Carry out following: say "You can't follow that."

Instead of following the global-path:
	say "You must specify a direction to go."

Instead of digging the global-path:
	say "Not a chance."

The global-teeth is a backdrop. The global-teeth is everywhere.
The printed name of the global-teeth is "teeth".
Understand "teeth" and "tooth" as the global-teeth.
The description of the global-teeth is "You have the usual complement of teeth."
Instead of brushing the global-teeth: say "Dental hygiene is highly recommended, but I'm not sure what you want to brush them with."

The global-zorkmid is a backdrop. The global-zorkmid is everywhere.
The printed name of the global-zorkmid is "zorkmid".
Understand "zorkmid" and "zorkmids" and "currency" as the global-zorkmid.
The description of the global-zorkmid is "The zorkmid is the unit of currency of the Great Underground Empire."

Instead of finding the global-zorkmid:
	say "The best way to find zorkmids is to go out and look for them."

Chapter 10 - Additional Game Verbs

Understand "xyzzy" as a mistake ("A hollow voice says [quotation mark]Fool.[quotation mark]").
Understand "plugh" as a mistake ("A hollow voice says [quotation mark]Fool.[quotation mark]").

Counting is an action applying to one thing. Understand "count [something]" as counting.
Carry out counting: say "You have lost your mind."

Counting-blessings is an action applying to nothing. Understand "count blessings" and "count my blessings" as counting-blessings.
Carry out counting-blessings: say "Well, for one, you are playing Zork..."

Instead of counting the pile of leaves: say "There are 69,105 leaves here."
Instead of counting the pair of candles: say "Let[apostrophe]s see, how many objects in a pair? Don[apostrophe]t tell me, I[apostrophe]ll get it."

Instead of counting the matchbook:
	let cnt be the match-count minus 1;
	say "You have ";
	if cnt is less than 1:
		say "no";
	otherwise:
		say "[cnt]";
	if cnt is 1:
		say " match.";
	otherwise:
		say " matches."

Instead of opening the matchbook:
	let cnt be the match-count minus 1;
	say "You have ";
	if cnt is less than 1:
		say "no";
	otherwise:
		say "[cnt]";
	if cnt is 1:
		say " match.";
	otherwise:
		say " matches."

Zorking is an action applying to nothing. Understand "zork" as zorking.
Carry out zorking: say "At your service!"

Frobozzing is an action applying to nothing. Understand "frobozz" as frobozzing.
Carry out frobozzing: say "The FROBOZZ Corporation created, owns, and operates this dungeon."

Winning is an action applying to nothing. Understand "win" as winning.
Carry out winning: say "Naturally!"

Yelling is an action applying to nothing. Understand "yell" and "scream" and "shout" as yelling.
Carry out yelling: say "Aaaarrrrgggghhhh!"

Repenting is an action applying to nothing. Understand "repent" as repenting.
Carry out repenting: say "It could very well be too late!"

Raping is an action applying to nothing. Understand "rape" as raping.
Carry out raping: say "What a (ahem!) strange idea."

Instead of turning something: say "This has no effect."

Instead of waiting: say "Time passes..."

Swimming is an action applying to nothing. Understand "swim" as swimming.
Instead of swimming: say "Swimming isn't usually allowed in the dungeon."

Understand "look behind [something]" as looking under.

Instead of kissing someone: say "I'd sooner kiss a pig."

Instead of smelling something: say "It smells like a [noun]."

Instead of listening to something: say "The [noun] makes no sound."

Chapter 10a - Burn Action

Burning it with is an action applying to two things. Understand "burn [something] with [something]" and "light [something] with [something]" as burning it with.

Instead of burning the pair of candles with the matchbook:
	if the match-lit is true:
		try lighting-candles the pair of candles instead;
	say "You should light the match first."
Instead of burning the pair of candles with the torch:
	say "The heat from the torch is so intense that the candles are vaporized.";
	remove the pair of candles from play.
Instead of burning the pair of candles with something:
	say "You have to light them with something that[apostrophe]s burning, you know."
Carry out burning it with:
	say "You can[apostrophe]t burn that."

Chapter 10b - Generic Verb Handlers

Section 1 - Simple One-Response Verbs

Answering-nobody is an action applying to nothing. Understand "answer" as answering-nobody.
Carry out answering-nobody: say "Nobody seems to be awaiting your answer."

Going-back is an action applying to nothing. Understand "back" and "go back" as going-back.
Carry out going-back: say "Sorry, my memory is poor. Please give a direction."

Blasting is an action applying to nothing. Understand "blast" as blasting.
Carry out blasting: say "You can't blast anything by using words."

Brushing is an action applying to one thing. Understand "brush [something]" as brushing.
Carry out brushing: say "If you wish, but heaven only knows why."

Brushing it with is an action applying to two things. Understand "brush [something] with [something]" as brushing it with.
Instead of brushing the global-teeth with the viscous material:
	die saying "Well, you seem to have been brushing your teeth with some sort of glue. As a result, your mouth gets glued together (with your nose) and you die of respiratory failure."
Instead of brushing the global-teeth with something:
	say "A nice idea, but with a [second noun]?"
Carry out brushing something with something: say "If you wish, but heaven only knows why."

Bugging is an action applying to nothing. Understand "bug" as bugging.
Carry out bugging: say "Bug? Not in a flawless program like this! (Cough, cough)."

Chomping is an action applying to one thing. Understand "bite [something]" and "chomp [something]" as chomping.
Carry out chomping: say "Preposterous!"

Instead of climbing something: say "You can't do that!"

Hatching is an action applying to one thing. Understand "hatch [something]" as hatching.
Carry out hatching: say "Bizarre!"

Instead of cutting something: say "Strange concept, cutting the [noun]...."

Cutting-with is an action applying to two things. Understand "cut [something] with [something]" and "slice [something] with [something]" as cutting-with.

Instead of cutting-with when the noun is a person:
	try attacking the noun.

Instead of cutting-with when the player is in the noun:
	say "Not a bright idea, especially since you[apostrophe]re in it."

Instead of cutting-with when the second noun is not a weapon:
	say "The [quotation mark]cutting edge[quotation mark] of a [second noun] is hardly adequate."

Instead of cutting-with:
	say "Strange concept, cutting the [noun]...."

Leaning-on is an action applying to one thing. Understand "lean on [something]" and "lean against [something]" as leaning-on.
Carry out leaning-on: say "Getting tired?"

Locking is an action applying to one thing. Understand "lock [something]" as locking.
Carry out locking: say "It doesn't seem to work."

Melting is an action applying to one thing. Understand "melt [something]" as melting.
Carry out melting: say "It's not clear that a [noun] can be melted."

Mumbling is an action applying to nothing. Understand "mumble" as mumbling.
Carry out mumbling: say "You'll have to speak up if you expect me to hear you!"

Oiling is an action applying to one thing. Understand "oil [something]" and "lubricate [something]" and "grease [something]" as oiling.
Carry out oiling: say "You probably put spinach in your gas tank, too."

Instead of putting the viscous material on something:
	if the second noun is the leak:
		try plugging the leak with the viscous material;
	otherwise:
		say "The all-purpose gunk isn[apostrophe]t a lubricant."

Lock-picking is an action applying to one thing. Understand "pick [something]" as lock-picking.
Carry out lock-picking: say "You can[apostrophe]t pick that."
Instead of lock-picking the grate: say "You can[apostrophe]t pick the lock."

Plugging is an action applying to one thing. Understand "plug [something]" as plugging.
Carry out plugging: say "This has no effect."

Putting-under is an action applying to two things. Understand "put [something] under [something]" as putting-under.
Carry out putting-under: say "You can't do that."

Hiding-behind is an action applying to two things. Understand "put [something] behind [something]" and "hide [something] behind [something]" as hiding-behind.
Carry out hiding-behind: say "That hiding place is too obvious."

Replying is an action applying to one thing. Understand "reply to [something]" and "reply [something]" as replying.
Carry out replying: say "It is hardly likely that the [noun] is interested."

Instead of searching a door:
	if the noun is open:
		say "The [noun] is open, but I can[apostrophe]t tell what[apostrophe]s beyond it.";
	otherwise:
		say "The [noun] is closed."
Instead of searching something that is not a container: say "You find nothing unusual."

Spinning is an action applying to one thing. Understand "spin [something]" as spinning.
Carry out spinning: say "You can't spin that!"

Stabbing is an action applying to one thing. Understand "stab [something]" as stabbing.
Carry out stabbing:
	let W be a random weapon carried by the player;
	if W is not nothing:
		try attacking the noun;
	otherwise:
		say "No doubt you propose to stab the [noun] with your pinky?"

Standing-up is an action applying to nothing. Understand "stand" and "stand up" as standing-up.
Carry out standing-up: say "You are already standing, I think."

Staying is an action applying to nothing. Understand "stay" as staying.
Carry out staying: say "You will be lost without me!"

Striking is an action applying to one thing. Understand "strike [something]" as striking.
Carry out striking:
	if the noun is a person:
		say "Since you aren't versed in hand-to-hand combat, you'd better attack the [noun] with a weapon.";
	otherwise:
		try switching on the noun.

Instead of swinging something: say "Whoosh!"

Throwing-off is an action applying to one thing. Understand "throw [something] off" as throwing-off.
Carry out throwing-off: say "You can't throw anything off of that!"

Tying-up is an action applying to two things. Understand "tie up [something] with [something]" and "tie [something] up with [something]" as tying-up.
Carry out tying-up: say "You could certainly never tie it with that!"

Treasuring is an action applying to nothing. Understand "treasure" as treasuring.
Carry out treasuring: say "Nothing happens."

Untieing is an action applying to one thing. Understand "untie [something]" as untieing.
Carry out untieing: say "This cannot be tied, so it cannot be untied!"

Walking-around is an action applying to nothing. Understand "walk around" as walking-around.
Carry out walking-around: say "Use compass directions for movement."

Instead of wearing something: say "You can't wear the [noun]."

Wishing is an action applying to nothing. Understand "wish" as wishing.
Carry out wishing: say "With luck, your wish will come true."

Drink-froming is an action applying to one thing. Understand "drink from [something]" as drink-froming.
Carry out drink-froming: say "How peculiar!"

Section 2 - Multi-Branch Verb Handlers

Cursing is an action applying to nothing. Understand "curse" and "damn" and "shit" and "fuck" as cursing.
Carry out cursing: say "Such language in a high-class establishment like this!"

Cursing-at is an action applying to one thing. Understand "curse [something]" and "damn [something]" as cursing-at.
Carry out cursing-at:
	if the noun is a person:
		say "Insults of this nature won't help you.";
	otherwise:
		say "What a loony!"

Commanding is an action applying to one thing. Understand "command [something]" as commanding.
Carry out commanding:
	if the noun is a person:
		say "The [noun] pays no attention.";
	otherwise:
		say "You cannot talk to that!"

Knocking-on is an action applying to one thing. Understand "knock on [something]" and "knock [something]" as knocking-on.
Carry out knocking-on:
	if the noun is a door:
		say "Nobody's home.";
	otherwise:
		say "Why knock on a [noun]?"

Instead of pushing something:
	if the player carries the noun:
		say "You aren[apostrophe]t an accomplished enough juggler.";
	otherwise if the noun is fixed in place:
		say "You can[apostrophe]t move the [noun].";
	otherwise:
		say "Moving the [noun] reveals nothing."

Instead of squeezing a person: say "The [noun] does not understand this."
Instead of squeezing something: say "How singularly useless."

Understand "spray [something]" as squeezing.

Sending is an action applying to one thing. Understand "send for [something]" and "send [something]" as sending.
Carry out sending:
	if the noun is a person:
		say "Why would you send for the [noun]?";
	otherwise:
		say "That doesn't make sends."

Walking-to is an action applying to one visible thing. Understand "walk to [something]" and "go to [something]" as walking-to.
Carry out walking-to:
	if the player can see the noun:
		say "It's here!";
	otherwise:
		say "You should supply a direction!"

Saying-something is an action applying to one topic. Understand "say [text]" as saying-something.
Carry out saying-something: say "Talking to yourself is a sign of impending mental collapse."

Section 3 - Hello and Greetings

Helloing is an action applying to one visible thing. Understand "hello [something]" and "greet [something]" and "hi [something]" as helloing.
Carry out helloing:
	if the noun is a person:
		say "The [noun] bows his head to you in greeting.";
	otherwise:
		say "It's a well known fact that only schizophrenics say [quotation mark]Hello[quotation mark] to a [noun]."

Helloing-nobody is an action applying to nothing. Understand "hello" and "hi" and "greetings" as helloing-nobody.
Carry out helloing-nobody:
	let R be a random number between 1 and 4;
	if R is 1:
		say "Hello.";
	otherwise if R is 2:
		say "Good day.";
	otherwise if R is 3:
		say "Nice weather we've been having lately.";
	otherwise:
		say "Goodbye."

Section 4 - Shaking

Shaking is an action applying to one thing. Understand "shake [something]" as shaking.

Instead of shaking the glass bottle:
	if the glass bottle is open and the quantity of water is in the glass bottle:
		remove the quantity of water from play;
		say "The water spills to the floor and evaporates.";
	otherwise:
		say "Shaken."

Carry out shaking:
	if the noun is a person:
		say "This seems to have no effect.";
	otherwise if the noun is fixed in place:
		say "You can't take it; thus, you can't shake it!";
	otherwise if the noun is an open container:
		let stuff-found be false;
		repeat with item running through things in the noun:
			now stuff-found is true;
			now item is in the location of the player;
		if stuff-found is true:
			say "The contents of the [noun] spill to the ground.";
		otherwise:
			say "Shaken.";
	otherwise if the noun is a closed container:
		let stuff-found be false;
		repeat with item running through things in the noun:
			now stuff-found is true;
		if stuff-found is true:
			say "It sounds like there is something inside the [noun].";
		otherwise:
			say "The [noun] sounds empty.";
	otherwise:
		say "Shaken."

Section 4b - Random Text Tables

[ZIL YUKS table - used for non-takeable objects and other futile actions]
To say yuks:
	let R be a random number between 1 and 3;
	if R is 1:
		say "A valiant attempt.";
	otherwise if R is 2:
		say "You can[apostrophe]t be serious.";
	otherwise:
		say "An interesting idea..."

[ZIL DUMMY table - used for already-open/already-closed/already-done responses]
To say dummy:
	let R be a random number between 1 and 3;
	if R is 1:
		say "Look around.";
	otherwise if R is 2:
		say "Too late for that.";
	otherwise:
		say "Have your eyes checked."

[ZIL JUMPLOSS table - random death messages for fatal jumps]
To say jumploss:
	let R be a random number between 1 and 3;
	if R is 1:
		say "You should have looked before you leaped.";
	otherwise if R is 2:
		say "In the movies, your life would be passing before your eyes.";
	otherwise:
		say "Geronimo..."

[ZIL uses rotating HO-HUM suffixes for several verbs]
To say ho-hum:
	let R be a random number between 1 and 3;
	if R is 1:
		say "doesn[apostrophe]t seem to work.";
	otherwise if R is 2:
		say "isn[apostrophe]t notably helpful.";
	otherwise:
		say "has no effect."

[ZIL V-KICK → I7 kicking]
Kicking is an action applying to one thing. Understand "kick [something]" as kicking.
Carry out kicking: say "Kicking the [noun] [ho-hum]"

Section 4c - FIND verb

Locating is an action applying to one visible thing. Understand "find [something]" and "where is [something]" as locating.
Carry out locating:
	if the noun is the global-hands or the noun is the global-lungs:
		say "Within six feet of your head, assuming you haven[apostrophe]t left that somewhere.";
	otherwise if the noun is the player:
		say "You[apostrophe]re around here somewhere...";
	otherwise if the player carries the noun:
		say "You have it.";
	otherwise if the noun is a person:
		if the player can see the noun:
			say "Right in front of you, perhaps?";
		otherwise:
			say "Beats me.";
	otherwise if the player can see the noun:
		say "You find it.";
	otherwise:
		say "Beats me."

Section 4d - SWIM verb

Pool-swimming is an action applying to nothing. Understand "swim" and "dive" as pool-swimming.
Carry out pool-swimming:
	if the global-water is in the location of the player:
		say "Swimming isn[apostrophe]t usually allowed in the dungeon.";
	otherwise:
		say "Go jump in a lake!"

Section 4e - Additional LOOK actions

Instead of looking under something: say "There is nothing but dust there."

Looking-behind is an action applying to one thing. Understand "look behind [something]" as looking-behind.
Carry out looking-behind: say "There is nothing behind the [noun]."

Looking-on is an action applying to one thing. Understand "look on [something]" as looking-on.
Carry out looking-on:
	if the noun is a supporter:
		try searching the noun;
	otherwise:
		say "Look on a [noun]???"

Section 5 - Throwing Overrides

Instead of throwing something at yourself:
	say "A terrific throw! The [noun] hits you squarely in the head. Normally, this wouldn[apostrophe]t do much damage, but by incredible mischance, you fall over backwards trying to duck, and break your neck, justice being swift and merciful in the Great Underground Empire.";
	die saying ""

Instead of throwing something at a person:
	if the second noun is the thief and the noun is a weapon:
		if a random chance of 1 in 10 succeeds:
			say "You evidently frightened the robber, though you didn't hit him. He flees.";
			let new-dest be a random dark room that is in the Underground;
			if new-dest is a room:
				move the thief to new-dest;
		otherwise:
			say "You missed. The thief makes no attempt to take the knife, though it would be a fine addition to the collection in his bag. He does seem angered by your attempt.";
		now the noun is in the location of the player;
	otherwise:
		say "The [second noun] ducks as the [noun] flies by and crashes to the ground.";
		now the noun is in the location of the player.

Instead of throwing something at something:
	say "Thrown.";
	now the noun is in the location of the player.

Section 6 - Jump / Leap Overrides

The wheeeee-count is a number that varies. The wheeeee-count is 0.

Instead of jumping:
	increase the wheeeee-count by 1;
	let R be the remainder after dividing the wheeeee-count by 4;
	if R is 1:
		say "Very good. Now you can go to the second grade.";
	otherwise if R is 2:
		say "Are you enjoying yourself?";
	otherwise if R is 3:
		say "Wheeeeeeeeee!!!!!";
	otherwise:
		say "Do you expect me to applaud?"

Section 7 - Through / Enter Overrides

Going-through is an action applying to one thing. Understand "go through [something]" and "walk through [something]" as going-through.
Carry out going-through:
	if the noun is a door:
		try entering the noun;
	otherwise if the player carries the noun:
		say "That would involve quite a contortion!";
	otherwise:
		say "You hit your head against the [noun] as you attempt this feat."

Section 8 - Eat Overrides

Instead of eating something:
	if the noun is edible:
		continue the action;
	otherwise:
		say "I don't think that the [noun] would agree with you."

Section 9 - Read Defaults

Instead of reading something:
	if in darkness:
		say "It is impossible to read in the dark.";
	otherwise:
		say "How does one read a [noun]?"

Section 10 - Alarm / Wake

Alarming is an action applying to one thing. Understand "alarm [something]" and "wake [something]" and "wake up [something]" as alarming.
Carry out alarming:
	if the noun is a person:
		if the noun is the troll and the troll is defeated:
			say "The troll is rudely awakened.";
		otherwise if the noun is the thief and the thief is defeated:
			say "The thief is rudely awakened.";
		otherwise if the noun is the cyclops and the cyclops-asleep is true:
			say "The cyclops is rudely awakened.";
		otherwise:
			say "The [noun] is wide awake, or haven[apostrophe]t you noticed...";
	otherwise:
		say "The [noun] isn[apostrophe]t sleeping."

Section 11 - Play

Playing is an action applying to one thing. Understand "play [something]" as playing.
Carry out playing:
	if the noun is a person:
		die saying "You become so engrossed in the role of the [noun] that you kill yourself, just as he might have done!";
	otherwise:
		say "That's silly!"

Section 12 - Dig Defaults

Instead of digging something:
	if the player does not carry the shovel:
		say "Digging with your hands is silly.";
	otherwise:
		say "There's no reason to be digging here."

Section 13 - Attack Defaults

Instead of attacking something:
	if the noun is not a person:
		say "I[apostrophe]ve known strange people, but fighting a [noun]?";
	otherwise:
		let W be a random weapon carried by the player;
		if W is nothing:
			say "Strangle him with your bare hands?";
		otherwise:
			continue the action.

Section 14 - Climb Defaults

Instead of climbing the granite-wall: say "Climbing the walls is to no avail."

Section 15 - Burn Defaults

Instead of burning something:
	if the player does not carry the matchbook and the player does not carry the torch:
		say "You should say what to burn it with.";
	otherwise:
		say "You can[apostrophe]t burn a [noun]."

Section 16 - Give Defaults

Instead of giving something to something:
	if the second noun is not a person:
		say "You can[apostrophe]t give a [noun] to a [second noun]!";
	otherwise:
		say "The [second noun] refuses it politely."

Section 17 - Tell Defaults

Instead of telling someone about something:
	say "The [noun] pauses for a moment, perhaps thinking that you should reread the manual."

Section 18 - Tie Defaults

Instead of tying something to yourself: say "You can[apostrophe]t tie anything to yourself."

Section 19 - Destroy / Mung

Destroying is an action applying to one thing. Understand "destroy [something]" and "mung [something]" and "damage [something]" as destroying.

Instead of destroying a person:
	try attacking the noun.

Instead of destroying something:
	say "Nice try."

Destroying-with is an action applying to two things. Understand "destroy [something] with [something]" and "mung [something] with [something]" as destroying-with.

Instead of destroying-with a person:
	try attacking the noun.

Instead of destroying-with when the second noun is a weapon:
	try attacking the noun.

Instead of destroying-with:
	say "Trying to destroy the [noun] with [if the player carries the second noun]a [second noun][otherwise]your bare hands[end if] is futile."

Section 20 - Overboard

Throwing-overboard is an action applying to one thing. Understand "throw [something] overboard" as throwing-overboard.

Instead of throwing-overboard when the player is in the magic boat:
	say "Ahoy -- [noun] overboard!";
	now the noun is in the location of the player.

Instead of throwing-overboard:
	say "Huh?"

Section 21 - Leaping Over

Leaping-over is an action applying to one thing. Understand "jump over [something]" and "leap over [something]" and "jump across [something]" as leaping-over.

Instead of leaping-over a person:
	say "The [noun] is too big to jump over."

Instead of leaping-over:
	continue the action.

Section 22 - Disembark Messages

Instead of exiting when the player is in the magic boat:
	let here be the location of the player;
	if here is River1 or here is River2 or here is River3 or here is River4 or here is River5:
		say "You realize that getting out here would be fatal.";
	otherwise if here is Reservoir or here is In-Stream:
		say "You realize that getting out here would be fatal.";
	otherwise:
		say "You are on your own feet again.";
		move the player to here.

Chapter 11 - Boat System

The magic boat is an open enterable vehicle. The carrying capacity of the magic boat is 10.
Understand "boat" and "raft" and "magic" and "plastic" and "seaworthy" and "inflat" as the magic boat.
The description of the magic boat is "It's a seaworthy magic boat."

The punctured boat is a thing. "There is a large punctured boat here."
Understand "boat" and "pile" and "plastic" and "punctured" and "large" as the punctured boat.
The description of the punctured boat is "It's a punctured boat beyond repair."

Instead of inflating the punctured boat: say "No chance. Some moron punctured it."

Instead of plugging the punctured boat with the viscous material:
	say "Well done. The boat is repaired.";
	now the punctured boat is nowhere;
	now the pile of plastic is in the location of the player.

The tan label is a thing. The tan label is in the magic boat.
Understand "label" and "fineprint" and "print" and "tan" and "fine" as the tan label.
The description of the tan label is "!!!!FROBOZZ MAGIC BOAT COMPANY!!!![paragraph break]Hello, Sailor![paragraph break]Instructions for use:[paragraph break]   To get into a body of water, say 'Launch'.[line break]   To get to shore, say 'Land' or the direction in which you want to maneuver the boat.[paragraph break]Warranty:[line break]  This boat is guaranteed against all defects for a period of 76 milliseconds from date of purchase or until first used, whichever comes first.[paragraph break]Warning:[line break]   This boat is made of thin plastic.[line break]   Good Luck!"

The boat-inflated is a truth state that varies. The boat-inflated is false.
The boat-punctured is a truth state that varies. The boat-punctured is false.

Inflating is an action applying to one thing. Understand "inflate [something]" and "pump up [something]" as inflating.
Carry out inflating: say "You can't inflate that."

Inflating-with is an action applying to two things. Understand "inflate [something] with [something]" and "pump up [something] with [something]" and "fill [something] with [something]" as inflating-with.

Instead of inflating-with the pile of plastic:
	if the second noun is the hand-held air pump:
		try inflating the pile of plastic;
	otherwise:
		say "With a [second noun]? Surely you jest!"

Instead of inflating-with:
	say "You can[apostrophe]t inflate that."

Instead of inflating the pile of plastic:
	if the pile of plastic is not in the location of the player:
		say "The boat must be on the ground to be inflated.";
	otherwise if the player carries the hand-held air pump or the hand-held air pump is in the location of the player:
		play the sound of inflate-sfx as sfx;
		say "The boat inflates and appears seaworthy.";
		if the tan label is not handled:
			say "A tan label is lying inside the boat.";
		now the boat-inflated is true;
		now the pile of plastic is nowhere;
		now the magic boat is in the location of the player;
	otherwise:
		say "You don[apostrophe]t have enough lung power to inflate it."

Instead of inflating the magic boat:
	say "Inflating it further would probably burst it."

Instead of reading the magic boat:
	say "Read the label for the boat's instructions."

Instead of deflating the magic boat when the player is in the magic boat and the location of the player is River1 or the location of the player is River2 or the location of the player is River3 or the location of the player is River4 or the location of the player is River5:
	die saying "You realize that getting out here would be fatal."

Deflating is an action applying to one thing. Understand "deflate [something]" as deflating.
Carry out deflating: say "You can't deflate that."

Instead of deflating the magic boat:
	if the player is in the magic boat:
		say "You can[apostrophe]t deflate the boat while you[apostrophe]re in it." instead;
	say "The boat deflates.";
	now the boat-inflated is false;
	let here be the location of the magic boat;
	repeat with item running through things in the magic boat:
		now item is in here;
	now the magic boat is nowhere;
	now the pile of plastic is in here.

The nonland-room is a truth state that varies. The nonland-room is false.

To decide whether on-water:
	let here be the location of the player;
	if here is River1 or here is River2 or here is River3 or here is River4 or here is River5:
		decide yes;
	if here is Reservoir or here is In-Stream:
		decide yes;
	decide no.

Instead of dropping a weapon when the player is in the magic boat and on-water:
	say "It seems that the [noun] didn[apostrophe]t agree with the boat, as evidenced by the loud hissing noise issuing therefrom. With a pathetic sputter, the boat deflates, leaving you without.";
	let here be the location of the player;
	now the magic boat is nowhere;
	now the punctured boat is in here;
	if here is Reservoir or here is In-Stream:
		die saying "[line break]Another pathetic sputter, this time from you, heralds your drowning.";
	otherwise:
		die saying "[line break]In other words, fighting the fierce currents of the Frigid River. You manage to hold your own for a bit, but then you are carried over a waterfall and into some nasty rocks. Ouch!"

Before entering the magic boat:
	let sharp-items be false;
	if the player carries the sword:
		now sharp-items is true;
	if the player carries the sceptre:
		now sharp-items is true;
	if the player carries the nasty knife:
		now sharp-items is true;
	if the player carries the rusty knife:
		now sharp-items is true;
	if sharp-items is true:
		say "Oops! Something sharp seems to have slipped and punctured the boat. The boat deflates to the sounds of hissing, sputtering, and cursing.";
		now the boat-punctured is true;
		let here be the location of the player;
		repeat with item running through things in the magic boat:
			now item is in here;
		now the magic boat is nowhere;
		now the punctured boat is in here;
		stop the action.

Launching is an action applying to nothing. Understand "launch" as launching.
Carry out launching:
	let here be the location of the player;
	if the player is not in the magic boat:
		say "You[apostrophe]re not in the boat!";
	otherwise if here is River1 or here is River2 or here is River3 or here is River4 or here is River5:
		say "You are on the river, or have you forgotten?";
	otherwise if here is Reservoir:
		say "You are on the reservoir, or have you forgotten?";
	otherwise if here is In-Stream:
		say "You are on the stream, or have you forgotten?";
	otherwise if here is Dam-Base:
		say "You push off from the shore.";
		move the magic boat to River1;
		now the river-current-active is true;
		now the river-current-timer is 2;
		try looking;
	otherwise if here is White Cliffs North:
		say "You push off from the shore.";
		move the magic boat to River3;
		now the river-current-active is true;
		now the river-current-timer is 1;
		try looking;
	otherwise if here is White Cliffs South:
		say "You push off from the shore.";
		move the magic boat to River4;
		now the river-current-active is true;
		now the river-current-timer is 2;
		try looking;
	otherwise if here is Shore:
		say "You push off from the shore.";
		move the magic boat to River5;
		now the river-current-active is true;
		now the river-current-timer is 1;
		try looking;
	otherwise if here is Sandy Beach:
		say "You push off from the shore.";
		move the magic boat to River4;
		now the river-current-active is true;
		now the river-current-timer is 2;
		try looking;
	otherwise if here is Reservoir-South or here is Reservoir-North:
		say "You push off from the shore.";
		move the magic boat to Reservoir;
		try looking;
	otherwise if here is Stream View:
		say "You push off from the shore.";
		move the magic boat to In-Stream;
		try looking;
	otherwise:
		say "You're not near any water."

Chapter 12 - Buoy and Emerald

After taking the red buoy:
	say "Taken.[line break]You notice something funny about the feel of the buoy.";
	continue the action.

The red buoy is in River4. "There is a red buoy here (probably a warning)."
Understand "buoy" and "red" as the red buoy.
The red buoy is a closed openable container. The carrying capacity of the red buoy is 3.

The large emerald is in the red buoy.
Understand "emerald" and "large" as the large emerald.
The treasure-value of the large emerald is 10.
The point-value of the large emerald is 5.

Chapter 13 - Trunk of Jewels

The trunk of jewels is in Reservoir. The trunk of jewels is zil-invisible.
Understand "trunk" and "chest" and "jewels" and "old" as the trunk of jewels.
The treasure-value of the trunk of jewels is 5.
The point-value of the trunk of jewels is 15.
The description of the trunk of jewels is "There is an old trunk here, bulging with assorted jewels."

Instead of opening the trunk of jewels: say "The jewels are safely inside; there[apostrophe]s no need to do that."
Instead of closing the trunk of jewels: say "The jewels are safely inside; there[apostrophe]s no need to do that."
Instead of inserting something into the trunk of jewels: say "Don[apostrophe]t be silly. It wouldn[apostrophe]t be a trunk of jewels anymore."
Instead of searching the trunk of jewels: say "There are lots of jewels in there."

After going to Reservoir:
	if the low-tide is true and the trunk of jewels is zil-invisible:
		now the trunk of jewels is zil-visible;
		say "Lying half buried in the mud is an old trunk, bulging with jewels.[line break]";
	continue the action.

Chapter 14 - Gate/Bolt Interaction

Instead of turning the bolt:
	if the player does not carry the wrench:
		say "The bolt won't turn with your best effort.";
	otherwise if the gate-flag is false:
		say "The bolt won't turn with your best effort.";
	otherwise if the gates-open is true:
		now the gates-open is false;
		now the reservoir-fill-timer is 8;
		say "The sluice gates close and water starts to collect behind the dam.";
	otherwise:
		now the gates-open is true;
		now the reservoir-empty-timer is 8;
		play the sound of flood-sfx as sfx;
		say "The sluice gates open and water pours through the dam."

The reservoir-fill-timer is a number that varies. The reservoir-fill-timer is 0.
The reservoir-empty-timer is a number that varies. The reservoir-empty-timer is 0.

Every turn when the reservoir-empty-timer > 0 (this is the reservoir emptying rule):
	decrease the reservoir-empty-timer by 1;
	if the reservoir-empty-timer is 0:
		now the low-tide is true;
		now the trunk of jewels is zil-visible;
		if the player is in Dam-Room:
			say "The water level behind the dam is now quite low.";
		if the player is in Deep Canyon:
			say "The roar of rushing water is quieter now.";
		if the player is in Reservoir-South or the player is in Reservoir-North:
			say "The water level is now quite low here and you could easily cross over to the other side.";
		if the player is in the magic boat and the location of the player is Reservoir:
			say "The water level has dropped to the point at which the boat can no longer stay afloat. It sinks into the mud."

Every turn when the reservoir-fill-timer > 0 (this is the reservoir filling rule):
	decrease the reservoir-fill-timer by 1;
	if the reservoir-fill-timer is 0:
		now the low-tide is false;
		now the trunk of jewels is zil-invisible;
		if the location of the player is Reservoir:
			if the player is in the magic boat:
				say "The boat lifts gently out of the mud and is now floating on the reservoir.";
			otherwise:
				die saying "You are lifted up by the rising river! You try to swim, but the currents are too strong. You come closer, closer to the awesome structure of Flood Control Dam #3. The dam beckons to you. The roar of the water nearly deafens you, but you remain conscious as you tumble over the dam toward your certain doom among the rocks at its base.";
		if the player is in Dam-Room:
			say "The water level behind the dam is now quite high.";
		if the player is in Deep Canyon:
			say "A sound, like that of flowing water, starts to come from below.";
		if the player is in Reservoir-South or the player is in Reservoir-North:
			say "You notice that the water level has risen to the point that it is impossible to cross."

Every turn when the location of the player is Reservoir and the player is not in the magic boat and the reservoir-fill-timer > 0 and the low-tide is true (this is the reservoir perilous warning rule):
	say "You notice that the water level here is rising rapidly. The currents are also becoming stronger. Staying here seems quite perilous!"

Chapter 15 - Room Entering Points

Chapter 16 - Test Commands

Test cellar with "n / n / u / take egg / d / s / e / open window / w / take sack / take bottle / w / take sword / take lantern / open case / put egg in case / e / turn on lantern / u / take rope / d / open sack / take garlic / w / move rug / open trap door / d".

Test troll with "s / drop sack / drop bottle / drop rope / e / take painting / w / n / n / attack troll / attack troll / attack troll / attack troll / attack troll / attack troll / attack troll / attack troll / attack troll / attack troll / attack troll / attack troll" holding the sword and the garlic.

Test cyclops with "e / e / e / echo / take platinum bar / w / n / ne / e / n / take matchbook / n / press yellow button / take wrench / take screwdriver / s / s / turn bolt / drop wrench / s / sw / s / w / w / w / s / e / u / sw / e / s / se / odysseus" holding the sword and the brass lantern.

Test dam with "n / ne / e / n / take matchbook / n / press yellow button / take wrench / take screwdriver / s / s / turn bolt / drop wrench" holding the brass lantern.

Test exorcism with "se / e / tie rope to railing / d / take torch / s / take bell / s / take book / take candles / d / d / ring bell / take candles / light match / light candles with match / read book / drop book / drop candles / s / take skull" holding the brass lantern and the rope and the matchbook.

Test machine with "n / d / take bracelet / e / ne / se / sw / d / d / s / take coal / n / u / u / n / e / s / n / u / s / put coal in basket / lower basket / n / d / e / ne / se / sw / d / d / w / drop lantern / w / take torch / take coal / take screwdriver / s / open lid / put coal in machine / close lid / turn on switch / drop screwdriver / open lid / take diamond" holding the brass lantern and the screwdriver.

Test boat with "ne / e / turn off lantern / d / inflate plastic / drop pump / turn on lantern / enter boat / launch" holding the brass lantern and the pile of plastic and the air pump.

